
num_trips,average_duration,start_station_id,start_station_name,start_dockcount,end_station_id,end_station_name,end_dockcount,subscribers,customers
9150,1188.0038251366116,50,Harry Bridges Plaza (Ferry Building),23,60,Embarcadero at Sansome,15,5483,3667
8508,306.66596144804805,69,San Francisco Caltrain 2 (330 Townsend),23,65,Townsend at 7th,15,8305,203
7620,581.7548556430479,61,2nd at Townsend,27,50,Harry Bridges Plaza (Ferry Building),23,6931,689
6888,637.5232288037159,50,Harry Bridges Plaza (Ferry Building),23,61,2nd at Townsend,27,6332,556
6874,511.0090194937462,60,Embarcadero at Sansome,15,74,Steuart at Market,23,6200,674
6836,279.12112346401335,65,Townsend at 7th,15,69,San Francisco Caltrain 2 (330 Townsend),23,6641,195
6351,697.7335852621641,51,Embarcadero at Folsom,19,70,San Francisco Caltrain (Townsend at 4th),19,6158,193
6215,797.0024135156875,70,San Francisco Caltrain (Townsend at 4th),19,50,Harry Bridges Plaza (Ferry Building),23,5709,506
6039,575.1725451233635,74,Steuart at Market,23,61,2nd at Townsend,27,5758,281
5959,730.4004027521386,74,Steuart at Market,23,70,San Francisco Caltrain (Townsend at 4th),19,5695,264
5796,664.9830917874407,55,Temporary Transbay Terminal (Howard at Beale),23,70,San Francisco Caltrain (Townsend at 4th),19,5699,97
5395,858.3139944392946,50,Harry Bridges Plaza (Ferry Building),23,70,San Francisco Caltrain (Townsend at 4th),19,4980,415
5358,295.8902575587912,65,Townsend at 7th,15,70,San Francisco Caltrain (Townsend at 4th),19,5174,184
5337,476.63575042158647,64,2nd at South Park,15,77,Market at Sansome,27,5205,132
5196,721.5552347959969,70,San Francisco Caltrain (Townsend at 4th),19,55,Temporary Transbay Terminal (Howard at Beale),23,5089,107
5118,609.5113325517772,67,Market at 10th,27,69,San Francisco Caltrain 2 (330 Townsend),23,5008,110
5110,792.8272015655583,74,Steuart at Market,23,60,Embarcadero at Sansome,15,4263,847
5063,402.48923563104785,77,Market at Sansome,27,64,2nd at South Park,15,4919,144
4737,877.9826894659061,60,Embarcadero at Sansome,15,50,Harry Bridges Plaza (Ferry Building),23,3099,1638
4492,578.5135796972389,69,San Francisco Caltrain 2 (330 Townsend),23,39,Powell Street BART,19,4352,140
4440,640.2781531531532,70,San Francisco Caltrain (Townsend at 4th),19,51,Embarcadero at Folsom,19,4367,73
4433,407.8980374464245,69,San Francisco Caltrain 2 (330 Townsend),23,57,5th at Howard,15,4298,135
4417,495.82499434004984,39,Powell Street BART,19,69,San Francisco Caltrain 2 (330 Townsend),23,4281,136
4367,769.667735287383,70,San Francisco Caltrain (Townsend at 4th),19,74,Steuart at Market,23,4182,185
4304,522.3875464684003,63,Howard at 2nd,19,70,San Francisco Caltrain (Townsend at 4th),19,4172,132
4273,577.0227006786818,61,2nd at Townsend,27,74,Steuart at Market,23,4079,194
3852,410.8242471443403,28,Mountain View Caltrain Station,23,27,Mountain View City Hall,15,3765,87
3818,590.1917234153995,76,Market at 4th,19,70,San Francisco Caltrain (Townsend at 4th),19,3591,227
3801,810.4583004472488,70,San Francisco Caltrain (Townsend at 4th),19,77,Market at Sansome,27,3671,130
3771,518.9371519490842,65,Townsend at 7th,15,72,Civic Center BART (7th at Market),23,3622,149
3755,845.6303595206392,69,San Francisco Caltrain 2 (330 Townsend),23,67,Market at 10th,27,3622,133
3749,693.6745798879685,77,Market at Sansome,27,70,San Francisco Caltrain (Townsend at 4th),19,3600,149
3698,589.6146565711183,72,Civic Center BART (7th at Market),23,65,Townsend at 7th,15,3613,85
3610,764.67700831025,67,Market at 10th,27,70,San Francisco Caltrain (Townsend at 4th),19,3479,131
3597,331.6196830692249,62,2nd at Folsom,19,77,Market at Sansome,27,3534,63
3520,425.5176136363627,27,Mountain View City Hall,15,28,Mountain View Caltrain Station,23,3393,127
3468,546.9114763552471,70,San Francisco Caltrain (Townsend at 4th),19,63,Howard at 2nd,19,3363,105
3451,742.5291219936244,56,Beale at Market,19,70,San Francisco Caltrain (Townsend at 4th),19,3343,108
3292,548.4501822600237,62,2nd at Folsom,19,70,San Francisco Caltrain (Townsend at 4th),19,3188,104
3222,466.64556176288033,57,5th at Howard,15,69,San Francisco Caltrain 2 (330 Townsend),23,3100,122
3215,487.73872472783773,4,Santa Clara at Almaden,11,2,San Jose Diridon Caltrain Station,27,3146,69
3207,520.1649516682254,55,Temporary Transbay Terminal (Howard at Beale),23,61,2nd at Townsend,27,3143,64
3196,359.513141426783,70,San Francisco Caltrain (Townsend at 4th),19,65,Townsend at 7th,15,3029,167
3171,291.412488174078,2,San Jose Diridon Caltrain Station,27,4,Santa Clara at Almaden,11,3140,31
3162,723.8946869070206,74,Steuart at Market,23,69,San Francisco Caltrain 2 (330 Townsend),23,3067,95
3153,548.7928956549316,73,Grant Avenue at Columbus Avenue,19,77,Market at Sansome,27,3032,121
3146,522.5772409408764,67,Market at 10th,27,76,Market at 4th,19,2809,337
3043,615.5764048636208,54,Embarcadero at Bryant,15,70,San Francisco Caltrain (Townsend at 4th),19,2796,247
3027,761.4648166501486,69,San Francisco Caltrain 2 (330 Townsend),23,50,Harry Bridges Plaza (Ferry Building),23,2805,222
2963,623.9422882213959,55,Temporary Transbay Terminal (Howard at Beale),23,69,San Francisco Caltrain 2 (330 Townsend),23,2927,36
2870,768.4836236933808,39,Powell Street BART,19,67,Market at 10th,27,2385,485
2866,4325.704466154926,60,Embarcadero at Sansome,15,60,Embarcadero at Sansome,15,321,2545
2830,585.036042402828,61,2nd at Townsend,27,77,Market at Sansome,27,2653,177
2828,632.7708628005657,69,San Francisco Caltrain 2 (330 Townsend),23,51,Embarcadero at Folsom,19,2780,48
2687,849.9389653889089,70,San Francisco Caltrain (Townsend at 4th),19,42,Davis at Jackson,15,2631,56
2642,915.7846328538991,42,Davis at Jackson,15,70,San Francisco Caltrain (Townsend at 4th),19,2560,82
2631,926.0756366400609,41,Clay at Battery,15,70,San Francisco Caltrain (Townsend at 4th),19,2557,74
2594,678.3064764841951,69,San Francisco Caltrain 2 (330 Townsend),23,55,Temporary Transbay Terminal (Howard at Beale),23,2557,37
2592,435.87615740740796,68,Yerba Buena Center of the Arts (3rd @ Howard),19,70,San Francisco Caltrain (Townsend at 4th),19,2456,136
2584,706.2589009287917,76,Market at 4th,19,67,Market at 10th,27,2299,285
2552,519.6539968652025,69,San Francisco Caltrain 2 (330 Townsend),23,63,Howard at 2nd,19,2509,43
2537,479.0496649586132,70,San Francisco Caltrain (Townsend at 4th),19,68,Yerba Buena Center of the Arts (3rd @ Howard),19,2401,136
2531,497.19478467009014,32,Castro Street and El Camino Real,11,28,Mountain View Caltrain Station,23,2385,146
2520,635.4904761904769,51,Embarcadero at Folsom,19,69,San Francisco Caltrain 2 (330 Townsend),23,2438,82
2512,710.1795382165612,69,San Francisco Caltrain 2 (330 Townsend),23,74,Steuart at Market,23,2432,80
2492,413.35513643659726,70,San Francisco Caltrain (Townsend at 4th),19,61,2nd at Townsend,27,2412,80
2482,543.149476228848,77,Market at Sansome,27,61,2nd at Townsend,27,2332,150
2469,841.8351559335753,70,San Francisco Caltrain (Townsend at 4th),19,67,Market at 10th,27,2339,130
2468,475.3914100486217,57,5th at Howard,15,70,San Francisco Caltrain (Townsend at 4th),19,2353,115
2425,397.3505154639177,64,2nd at South Park,15,70,San Francisco Caltrain (Townsend at 4th),19,2379,46
2393,937.0990388633514,82,Broadway St at Battery St,15,70,San Francisco Caltrain (Townsend at 4th),19,2322,71
2364,5981.338832487325,50,Harry Bridges Plaza (Ferry Building),23,50,Harry Bridges Plaza (Ferry Building),23,360,2004
2355,563.792781316348,63,Howard at 2nd,19,69,San Francisco Caltrain 2 (330 Townsend),23,2288,67
2353,518.6485337866559,61,2nd at Townsend,27,70,San Francisco Caltrain (Townsend at 4th),19,2279,74
2350,489.57063829787216,48,Embarcadero at Vallejo,15,74,Steuart at Market,23,2196,154
2317,1268.6132930513575,70,San Francisco Caltrain (Townsend at 4th),19,60,Embarcadero at Sansome,15,1917,400
2307,617.6861725184227,70,San Francisco Caltrain (Townsend at 4th),19,54,Embarcadero at Bryant,15,2197,110
2303,756.3317412071224,69,San Francisco Caltrain 2 (330 Townsend),23,77,Market at Sansome,27,2235,68
2281,604.8535729943015,49,Spear at Folsom,19,70,San Francisco Caltrain (Townsend at 4th),19,2175,106
2266,582.038393645189,28,Mountain View Caltrain Station,23,32,Castro Street and El Camino Real,11,2172,94
2250,1423.0622222222214,54,Embarcadero at Bryant,15,60,Embarcadero at Sansome,15,1571,679
2214,726.8197831978326,77,Market at Sansome,27,50,Harry Bridges Plaza (Ferry Building),23,1752,462
2208,618.218297101448,67,Market at 10th,27,39,Powell Street BART,19,1818,390
2186,624.0960658737409,64,2nd at South Park,15,50,Harry Bridges Plaza (Ferry Building),23,1974,212
2186,767.0155535224148,39,Powell Street BART,19,70,San Francisco Caltrain (Townsend at 4th),19,2033,153
2184,930.5178571428556,65,Townsend at 7th,15,50,Harry Bridges Plaza (Ferry Building),23,2011,173
2178,820.2713498622613,70,San Francisco Caltrain (Townsend at 4th),19,39,Powell Street BART,19,1967,211
2133,501.6460384435071,61,2nd at Townsend,27,55,Temporary Transbay Terminal (Howard at Beale),23,2080,53
2125,858.7750588235302,70,San Francisco Caltrain (Townsend at 4th),19,56,Beale at Market,19,2072,53
2123,862.0447479981151,55,Temporary Transbay Terminal (Howard at Beale),23,65,Townsend at 7th,15,2083,40
2102,666.462416745956,54,Embarcadero at Bryant,15,50,Harry Bridges Plaza (Ferry Building),23,1696,406
2080,435.4230769230764,55,Temporary Transbay Terminal (Howard at Beale),23,57,5th at Howard,15,2007,73
2043,527.2648066568755,74,Steuart at Market,23,54,Embarcadero at Bryant,15,1888,155
2023,1255.4705882352941,60,Embarcadero at Sansome,15,70,San Francisco Caltrain (Townsend at 4th),19,1595,428
1953,734.5529953917054,77,Market at Sansome,27,69,San Francisco Caltrain 2 (330 Townsend),23,1875,78
1931,583.6198860693949,51,Embarcadero at Folsom,19,61,2nd at Townsend,27,1682,249
1914,988.8861024033448,50,Harry Bridges Plaza (Ferry Building),23,69,San Francisco Caltrain 2 (330 Townsend),23,1772,142
1905,937.926509186352,70,San Francisco Caltrain (Townsend at 4th),19,41,Clay at Battery,15,1857,48
1869,457.69127875869515,70,San Francisco Caltrain (Townsend at 4th),19,57,5th at Howard,15,1727,142
1858,1013.5575888051668,50,Harry Bridges Plaza (Ferry Building),23,65,Townsend at 7th,15,1733,125
1854,481.9827400215741,56,Beale at Market,19,82,Broadway St at Battery St,15,1828,26
1851,995.2366288492691,65,Townsend at 7th,15,55,Temporary Transbay Terminal (Howard at Beale),23,1812,39
1834,820.1810250817881,60,Embarcadero at Sansome,15,55,Temporary Transbay Terminal (Howard at Beale),23,1725,109
1833,1797.7463175122746,50,Harry Bridges Plaza (Ferry Building),23,48,Embarcadero at Vallejo,15,965,868
1828,840.6646608315097,75,Mechanics Plaza (Market at Battery),19,70,San Francisco Caltrain (Townsend at 4th),19,1761,67
1824,668.0723684210532,70,San Francisco Caltrain (Townsend at 4th),19,49,Spear at Folsom,19,1758,66
1819,758.5101704233107,66,South Van Ness at Market,19,69,San Francisco Caltrain 2 (330 Townsend),23,1750,69
1804,1474.9578713968995,77,Market at Sansome,27,60,Embarcadero at Sansome,15,1168,636
1794,1063.1488294314358,70,San Francisco Caltrain (Townsend at 4th),19,48,Embarcadero at Vallejo,15,1663,131
1782,474.9410774410772,70,San Francisco Caltrain (Townsend at 4th),19,62,2nd at Folsom,19,1693,89
1770,881.6158192090389,45,Commercial at Montgomery,15,70,San Francisco Caltrain (Townsend at 4th),19,1690,80
1739,632.5675675675664,74,Steuart at Market,23,48,Embarcadero at Vallejo,15,1533,206
1729,706.3927125506082,50,Harry Bridges Plaza (Ferry Building),23,54,Embarcadero at Bryant,15,1453,276
1691,897.8929627439387,56,Beale at Market,19,60,Embarcadero at Sansome,15,1373,318
1676,609.9612171837712,76,Market at 4th,19,55,Temporary Transbay Terminal (Howard at Beale),23,1631,45
1676,472.11873508353216,2,San Jose Diridon Caltrain Station,27,6,San Pedro Square,15,1598,78
1661,457.3570138470799,49,Spear at Folsom,19,61,2nd at Townsend,27,1571,90
1661,369.7784467188441,29,San Antonio Caltrain Station,23,31,San Antonio Shopping Center,15,1590,71
1656,530.4999999999999,61,2nd at Townsend,27,65,Townsend at 7th,15,1547,109
1655,440.34199395770383,55,Temporary Transbay Terminal (Howard at Beale),23,45,Commercial at Montgomery,15,1637,18
1653,430.1935874168185,31,San Antonio Shopping Center,15,29,San Antonio Caltrain Station,23,1610,43
1651,694.3646274984852,50,Harry Bridges Plaza (Ferry Building),23,64,2nd at South Park,15,1498,153
1649,574.2868405093993,54,Embarcadero at Bryant,15,74,Steuart at Market,23,1512,137
1641,469.3083485679458,62,2nd at Folsom,19,50,Harry Bridges Plaza (Ferry Building),23,1523,118
1637,2274.0122174709836,48,Embarcadero at Vallejo,15,60,Embarcadero at Sansome,15,292,1345
1632,900.6605392156861,54,Embarcadero at Bryant,15,48,Embarcadero at Vallejo,15,1354,278
1619,654.591105620754,56,Beale at Market,19,61,2nd at Townsend,27,1528,91
1619,644.2742433600987,60,Embarcadero at Sansome,15,56,Beale at Market,19,1374,245
1617,547.1873840445263,76,Market at 4th,19,69,San Francisco Caltrain 2 (330 Townsend),23,1518,99
1615,742.078637770898,56,Beale at Market,19,69,San Francisco Caltrain 2 (330 Townsend),23,1575,40
1608,607.3681592039792,73,Grant Avenue at Columbus Avenue,19,51,Embarcadero at Folsom,19,1573,35
1604,435.47880299251847,68,Yerba Buena Center of the Arts (3rd @ Howard),19,69,San Francisco Caltrain 2 (330 Townsend),23,1548,56
1604,1114.8216957605975,60,Embarcadero at Sansome,15,61,2nd at Townsend,27,1021,583
1574,856.6575603557815,70,San Francisco Caltrain (Townsend at 4th),19,75,Mechanics Plaza (Market at Battery),19,1525,49
1571,387.7447485677912,61,2nd at Townsend,27,63,Howard at 2nd,19,1498,73
1568,442.68686224489835,6,San Pedro Square,15,2,San Jose Diridon Caltrain Station,27,1504,64
1566,1058.2733077905502,73,Grant Avenue at Columbus Avenue,19,70,San Francisco Caltrain (Townsend at 4th),19,1429,137
1550,188.14645161290343,56,Beale at Market,19,55,Temporary Transbay Terminal (Howard at Beale),23,1533,17
1536,562.5865885416665,55,Temporary Transbay Terminal (Howard at Beale),23,76,Market at 4th,19,1467,69
1527,475.2809430255407,64,2nd at South Park,15,69,San Francisco Caltrain 2 (330 Townsend),23,1485,42
1515,885.515511551156,39,Powell Street BART,19,66,South Van Ness at Market,19,1141,374
1514,763.7239101717299,67,Market at 10th,27,77,Market at Sansome,27,1335,179
1513,959.8175809649708,70,San Francisco Caltrain (Townsend at 4th),19,82,Broadway St at Battery St,15,1458,55
1470,385.1319727891155,82,Broadway St at Battery St,15,74,Steuart at Market,23,1436,34
1469,951.9196732471065,74,Steuart at Market,23,65,Townsend at 7th,15,1393,76
1469,541.6051735874744,61,2nd at Townsend,27,51,Embarcadero at Folsom,19,1356,113
1461,769.7446954141006,50,Harry Bridges Plaza (Ferry Building),23,77,Market at Sansome,27,1251,210
1456,554.643543956044,65,Townsend at 7th,15,61,2nd at Townsend,27,1316,140
1450,919.3682758620688,51,Embarcadero at Folsom,19,60,Embarcadero at Sansome,15,1079,371
1447,498.1879751209405,55,Temporary Transbay Terminal (Howard at Beale),23,82,Broadway St at Battery St,15,1438,9
1445,683.6041522491349,66,South Van Ness at Market,19,72,Civic Center BART (7th at Market),23,1360,85
1445,355.8221453287196,62,2nd at Folsom,19,61,2nd at Townsend,27,1355,90
1444,1127.0401662049867,48,Embarcadero at Vallejo,15,70,San Francisco Caltrain (Townsend at 4th),19,1257,187
1443,752.0796950796959,70,San Francisco Caltrain (Townsend at 4th),19,76,Market at 4th,19,1300,143
1438,636.2447844228091,60,Embarcadero at Sansome,15,51,Embarcadero at Folsom,19,1126,312
1437,406.7724425887265,82,Broadway St at Battery St,15,56,Beale at Market,19,1425,12
1431,695.7840670859546,42,Davis at Jackson,15,60,Embarcadero at Sansome,15,1200,231
1430,1177.1811188811196,76,Market at 4th,19,50,Harry Bridges Plaza (Ferry Building),23,817,613
1425,812.124912280701,66,South Van Ness at Market,19,77,Market at Sansome,27,1340,85
1410,571.2602836879431,62,2nd at Folsom,19,69,San Francisco Caltrain 2 (330 Townsend),23,1355,55
1409,562.5124201561396,66,South Van Ness at Market,19,39,Powell Street BART,19,1205,204
1400,482.67285714285674,45,Commercial at Montgomery,15,77,Market at Sansome,27,1364,36
1398,551.0429184549353,30,Evelyn Park and Ride,15,28,Mountain View Caltrain Station,23,1300,98
1397,704.3035075161048,55,Temporary Transbay Terminal (Howard at Beale),23,60,Embarcadero at Sansome,15,1310,87
1397,527.4180386542596,2,San Jose Diridon Caltrain Station,27,7,Paseo de San Antonio,15,1357,40
1391,497.10999281092757,57,5th at Howard,15,55,Temporary Transbay Terminal (Howard at Beale),23,1352,39
1385,392.2447653429603,77,Market at Sansome,27,62,2nd at Folsom,19,1354,31
1374,1171.8427947598261,60,Embarcadero at Sansome,15,77,Market at Sansome,27,954,420
1372,436.31851311953375,70,San Francisco Caltrain (Townsend at 4th),19,64,2nd at South Park,15,1319,53
1343,779.9270290394633,39,Powell Street BART,19,65,Townsend at 7th,15,1227,116
1342,1539.9821162444105,61,2nd at Townsend,27,60,Embarcadero at Sansome,15,796,546
1311,459.06025934401237,64,2nd at South Park,15,63,Howard at 2nd,19,1265,46
1308,647.3623853211019,60,Embarcadero at Sansome,15,41,Clay at Battery,15,999,309
1306,593.3231240428798,67,Market at 10th,27,65,Townsend at 7th,15,1220,86
1303,568.1611665387572,69,San Francisco Caltrain 2 (330 Townsend),23,68,Yerba Buena Center of the Arts (3rd @ Howard),19,1250,53
1300,2482.4100000000008,76,Market at 4th,19,60,Embarcadero at Sansome,15,530,770
1293,300.35962877030164,63,Howard at 2nd,19,64,2nd at South Park,15,1232,61
1290,369.76744186046494,51,Embarcadero at Folsom,19,54,Embarcadero at Bryant,15,1202,88
1285,769.9424124513614,37,Cowper at University,11,34,Palo Alto Caltrain Station,23,1219,66
1285,761.4677042801557,66,South Van Ness at Market,19,70,San Francisco Caltrain (Townsend at 4th),19,1225,60
1285,414.1284046692604,45,Commercial at Montgomery,15,55,Temporary Transbay Terminal (Howard at Beale),23,1267,18
1281,654.0624512099919,77,Market at Sansome,27,73,Grant Avenue at Columbus Avenue,19,1168,113
1276,633.2084639498419,49,Spear at Folsom,19,69,San Francisco Caltrain 2 (330 Townsend),23,1240,36
1272,1604.9386792452856,60,Embarcadero at Sansome,15,76,Market at 4th,19,571,701
1260,566.7952380952373,55,Temporary Transbay Terminal (Howard at Beale),23,48,Embarcadero at Vallejo,15,1227,33
1252,496.8841853035149,54,Embarcadero at Bryant,15,51,Embarcadero at Folsom,19,1169,83
1246,680.3418940609943,63,Howard at 2nd,19,61,2nd at Townsend,27,1176,70
1233,695.394160583941,72,Civic Center BART (7th at Market),23,66,South Van Ness at Market,19,1056,177
1231,1086.1145410235586,75,Mechanics Plaza (Market at Battery),19,76,Market at 4th,19,1033,198
1230,595.238211382114,50,Harry Bridges Plaza (Ferry Building),23,63,Howard at 2nd,19,1136,94
1229,466.53946297803094,64,2nd at South Park,15,55,Temporary Transbay Terminal (Howard at Beale),23,1211,18
1229,455.1261187957685,55,Temporary Transbay Terminal (Howard at Beale),23,64,2nd at South Park,15,1205,24
1226,719.9168026101147,67,Market at 10th,27,72,Civic Center BART (7th at Market),23,1137,89
1216,1110.1249999999998,60,Embarcadero at Sansome,15,54,Embarcadero at Bryant,15,801,415
1215,333.87325102880664,61,2nd at Townsend,27,62,2nd at Folsom,19,1152,63
1202,671.9392678868549,47,Post at Kearny,19,70,San Francisco Caltrain (Townsend at 4th),19,1152,50
1200,699.575,66,South Van Ness at Market,19,76,Market at 4th,19,985,215
1199,994.3327773144283,60,Embarcadero at Sansome,15,75,Mechanics Plaza (Market at Battery),19,768,431
1195,699.9338912133896,34,Palo Alto Caltrain Station,23,37,Cowper at University,11,1117,78
1187,812.7127211457453,72,Civic Center BART (7th at Market),23,76,Market at 4th,19,957,230
1184,8485.947635135131,35,University and Emerson,11,35,University and Emerson,11,71,1113
1181,846.6782387806949,71,Powell at Post (Union Square),19,70,San Francisco Caltrain (Townsend at 4th),19,1044,137
1179,540.643765903308,73,Grant Avenue at Columbus Avenue,19,55,Temporary Transbay Terminal (Howard at Beale),23,1160,19
1179,645.6284987277346,65,Townsend at 7th,15,66,South Van Ness at Market,19,1128,51
1173,517.8167092924116,61,2nd at Townsend,27,49,Spear at Folsom,19,1103,70
1161,775.3919035314394,73,Grant Avenue at Columbus Avenue,19,76,Market at 4th,19,930,231
1157,918.3448573898003,69,San Francisco Caltrain 2 (330 Townsend),23,66,South Van Ness at Market,19,1101,56
1156,1066.7984429065764,70,San Francisco Caltrain (Townsend at 4th),19,66,South Van Ness at Market,19,1055,101
1156,278.5207612456746,61,2nd at Townsend,27,69,San Francisco Caltrain 2 (330 Townsend),23,1121,35
1146,460.8080279232108,28,Mountain View Caltrain Station,23,30,Evelyn Park and Ride,15,1069,77
1143,450.98425196850394,82,Broadway St at Battery St,15,55,Temporary Transbay Terminal (Howard at Beale),23,1130,13
1139,1152.5548726953466,41,Clay at Battery,15,60,Embarcadero at Sansome,15,782,357
1134,881.208994708995,70,San Francisco Caltrain (Townsend at 4th),19,45,Commercial at Montgomery,15,1080,54
1133,977.0909090909079,72,Civic Center BART (7th at Market),23,67,Market at 10th,27,959,174
1131,892.6215738284717,77,Market at Sansome,27,74,Steuart at Market,23,865,266
1128,515.8563829787236,69,San Francisco Caltrain 2 (330 Townsend),23,62,2nd at Folsom,19,1085,43
1126,541.2362344582594,60,Embarcadero at Sansome,15,42,Davis at Jackson,15,978,148
1119,560.123324396783,11,MLK Library,19,2,San Jose Diridon Caltrain Station,27,1076,43
1117,1853.4046553267676,60,Embarcadero at Sansome,15,39,Powell Street BART,19,589,528
1115,383.1300448430496,82,Broadway St at Battery St,15,75,Mechanics Plaza (Market at Battery),19,1084,31
1112,305.26079136690635,55,Temporary Transbay Terminal (Howard at Beale),23,41,Clay at Battery,15,1100,12
1107,698.1345980126472,69,San Francisco Caltrain 2 (330 Townsend),23,72,Civic Center BART (7th at Market),23,1048,59
1101,419.8837420526797,71,Powell at Post (Union Square),19,63,Howard at 2nd,19,1064,37
1097,624.2269826800363,2,San Jose Diridon Caltrain Station,27,11,MLK Library,19,1033,64
1093,874.5260750228731,69,San Francisco Caltrain 2 (330 Townsend),23,42,Davis at Jackson,15,1058,35
1092,681.9075091575078,54,Embarcadero at Bryant,15,75,Mechanics Plaza (Market at Battery),19,1035,57
1089,288.90633608815466,62,2nd at Folsom,19,49,Spear at Folsom,19,1063,26
1087,709.1462741490342,70,San Francisco Caltrain (Townsend at 4th),19,47,Post at Kearny,19,1005,82
1084,784.4040590405903,66,South Van Ness at Market,19,65,Townsend at 7th,15,1043,41
1080,244.44722222222254,62,2nd at Folsom,19,55,Temporary Transbay Terminal (Howard at Beale),23,1068,12
1077,355.1142061281335,63,Howard at 2nd,19,57,5th at Howard,15,1015,62
1075,467.19162790697686,73,Grant Avenue at Columbus Avenue,19,56,Beale at Market,19,1027,48
1074,1360.760707635009,50,Harry Bridges Plaza (Ferry Building),23,76,Market at 4th,19,598,476
1072,936.134328358209,39,Powell Street BART,19,77,Market at Sansome,27,967,105
1072,1636.1856343283598,48,Embarcadero at Vallejo,15,50,Harry Bridges Plaza (Ferry Building),23,652,420
1059,300.9688385269122,5,Adobe on Almaden,19,2,San Jose Diridon Caltrain Station,27,995,64
1057,584.2894985808891,56,Beale at Market,19,48,Embarcadero at Vallejo,15,966,91
1055,585.5611374407575,74,Steuart at Market,23,64,2nd at South Park,15,972,83
1052,682.3193916349804,69,San Francisco Caltrain 2 (330 Townsend),23,76,Market at 4th,19,980,72
1046,854.945506692159,42,Davis at Jackson,15,61,2nd at Townsend,27,965,81
1045,773.6698564593304,72,Civic Center BART (7th at Market),23,69,San Francisco Caltrain 2 (330 Townsend),23,993,52
1045,386.97511961722535,73,Grant Avenue at Columbus Avenue,19,45,Commercial at Montgomery,15,996,49
1040,1000.6423076923089,82,Broadway St at Battery St,15,69,San Francisco Caltrain 2 (330 Townsend),23,1011,29
1035,376.34492753623175,41,Clay at Battery,15,55,Temporary Transbay Terminal (Howard at Beale),23,1014,21
1029,298.2876579203107,56,Beale at Market,19,45,Commercial at Montgomery,15,1009,20
1028,655.5817120622573,54,Embarcadero at Bryant,15,61,2nd at Townsend,27,813,215
1024,2624.326171875,71,Powell at Post (Union Square),19,60,Embarcadero at Sansome,15,405,619
1021,746.5142017629779,61,2nd at Townsend,27,42,Davis at Jackson,15,945,76
1017,625.6529006882981,7,Paseo de San Antonio,15,2,San Jose Diridon Caltrain Station,27,962,55
1015,1376.805911330048,50,Harry Bridges Plaza (Ferry Building),23,62,2nd at Folsom,19,961,54
1013,310.674234945705,74,Steuart at Market,23,51,Embarcadero at Folsom,19,976,37
1006,1047.094433399602,55,Temporary Transbay Terminal (Howard at Beale),23,66,South Van Ness at Market,19,944,62
1006,477.97713717693887,63,Howard at 2nd,19,50,Harry Bridges Plaza (Ferry Building),23,897,109
1003,788.8673978065807,69,San Francisco Caltrain 2 (330 Townsend),23,56,Beale at Market,19,972,31
1003,376.55333998005943,63,Howard at 2nd,19,74,Steuart at Market,23,946,57
1001,337.75424575424597,77,Market at Sansome,27,45,Commercial at Montgomery,15,976,25
1000,445.2249999999996,77,Market at Sansome,27,42,Davis at Jackson,15,955,45
1000,797.3040000000002,70,San Francisco Caltrain (Townsend at 4th),19,72,Civic Center BART (7th at Market),23,900,100
994,923.161971830986,55,Temporary Transbay Terminal (Howard at Beale),23,67,Market at 10th,27,952,42
984,736.0447154471545,59,Golden Gate at Polk,23,69,San Francisco Caltrain 2 (330 Townsend),23,949,35
984,938.8556910569097,2,San Jose Diridon Caltrain Station,27,9,Japantown,15,941,43
981,520.5300713557593,2,San Jose Diridon Caltrain Station,27,5,Adobe on Almaden,19,932,49
981,792.8990825688078,76,Market at 4th,19,74,Steuart at Market,23,539,442
974,893.383983572895,50,Harry Bridges Plaza (Ferry Building),23,75,Mechanics Plaza (Market at Battery),19,807,167
973,616.0914696813965,72,Civic Center BART (7th at Market),23,70,San Francisco Caltrain (Townsend at 4th),19,915,58
973,701.345323741007,65,Townsend at 7th,15,67,Market at 10th,27,901,72
970,622.4030927835046,54,Embarcadero at Bryant,15,69,San Francisco Caltrain 2 (330 Townsend),23,880,90
957,1661.7533960292576,50,Harry Bridges Plaza (Ferry Building),23,39,Powell Street BART,19,524,433
953,373.6190975865688,73,Grant Avenue at Columbus Avenue,19,41,Clay at Battery,15,891,62
952,1525.6386554621836,39,Powell Street BART,19,72,Civic Center BART (7th at Market),23,705,247
948,537.0189873417718,55,Temporary Transbay Terminal (Howard at Beale),23,63,Howard at 2nd,19,905,43
944,8170.68750000001,76,Market at 4th,19,76,Market at 4th,19,133,811
944,268.11440677966084,62,2nd at Folsom,19,64,2nd at South Park,15,901,43
940,507.5297872340418,48,Embarcadero at Vallejo,15,55,Temporary Transbay Terminal (Howard at Beale),23,904,36
932,684.3154506437766,76,Market at 4th,19,72,Civic Center BART (7th at Market),23,802,130
929,380.12594187298237,45,Commercial at Montgomery,15,42,Davis at Jackson,15,907,22
927,525.2384034519966,74,Steuart at Market,23,63,Howard at 2nd,19,878,49
926,1024.0907127429816,50,Harry Bridges Plaza (Ferry Building),23,68,Yerba Buena Center of the Arts (3rd @ Howard),19,766,160
919,1011.9782372143632,67,Market at 10th,27,74,Steuart at Market,23,669,250
913,913.0339539978095,69,San Francisco Caltrain 2 (330 Townsend),23,82,Broadway St at Battery St,15,881,32
912,830.1666666666671,72,Civic Center BART (7th at Market),23,77,Market at Sansome,27,813,99
911,5462.517014270036,74,Steuart at Market,23,74,Steuart at Market,23,281,630
908,697.3116740088108,47,Post at Kearny,19,69,San Francisco Caltrain 2 (330 Townsend),23,883,25
906,723.0187637969087,48,Embarcadero at Vallejo,15,54,Embarcadero at Bryant,15,763,143
902,775.6851441241678,65,Townsend at 7th,15,39,Powell Street BART,19,791,111
899,1187.8131256952172,75,Mechanics Plaza (Market at Battery),19,39,Powell Street BART,19,734,165
897,452.96544035674447,55,Temporary Transbay Terminal (Howard at Beale),23,50,Harry Bridges Plaza (Ferry Building),23,843,54
895,442.6424581005589,69,San Francisco Caltrain 2 (330 Townsend),23,64,2nd at South Park,15,880,15
895,3133.2290502793344,61,2nd at Townsend,27,61,2nd at Townsend,27,451,444
895,256.77094972067044,74,Steuart at Market,23,49,Spear at Folsom,19,872,23
893,845.2082866741323,69,San Francisco Caltrain 2 (330 Townsend),23,59,Golden Gate at Polk,23,859,34
893,663.7973124300103,45,Commercial at Montgomery,15,54,Embarcadero at Bryant,15,870,23
889,338.60967379077675,55,Temporary Transbay Terminal (Howard at Beale),23,68,Yerba Buena Center of the Arts (3rd @ Howard),19,839,50
888,500.97972972972906,74,Steuart at Market,23,82,Broadway St at Battery St,15,863,25
888,662.0450450450456,64,2nd at South Park,15,65,Townsend at 7th,15,820,68
888,890.8130630630625,65,Townsend at 7th,15,63,Howard at 2nd,19,863,25
885,848.9039548022598,41,Clay at Battery,15,61,2nd at Townsend,27,801,84
883,2247.0033975084943,60,Embarcadero at Sansome,15,48,Embarcadero at Vallejo,15,275,608
882,658.9784580498873,71,Powell at Post (Union Square),19,69,San Francisco Caltrain 2 (330 Townsend),23,812,70
878,794.571753986334,57,5th at Howard,15,74,Steuart at Market,23,775,103
877,645.0957810718357,67,Market at 10th,27,47,Post at Kearny,19,825,52
872,1838.4334862385315,75,Mechanics Plaza (Market at Battery),19,60,Embarcadero at Sansome,15,478,394
867,1575.3206459054206,76,Market at 4th,19,77,Market at Sansome,27,690,177
867,1012.031141868513,49,Spear at Folsom,19,65,Townsend at 7th,15,824,43
866,1172.6893764434203,76,Market at 4th,19,66,South Van Ness at Market,19,633,233
862,312.64501160092794,77,Market at Sansome,27,55,Temporary Transbay Terminal (Howard at Beale),23,843,19
860,662.2255813953502,59,Golden Gate at Polk,23,65,Townsend at 7th,15,824,36
859,503.5005820721771,13,St James Park,15,2,San Jose Diridon Caltrain Station,27,841,18
857,531.83430571762,49,Spear at Folsom,19,50,Harry Bridges Plaza (Ferry Building),23,754,103
852,654.2934272300471,84,Ryland Park,15,2,San Jose Diridon Caltrain Station,27,821,31
851,428.89776733255036,49,Spear at Folsom,19,74,Steuart at Market,23,810,41
847,1330.6340023612747,61,2nd at Townsend,27,48,Embarcadero at Vallejo,15,641,206
844,756.5308056872041,55,Temporary Transbay Terminal (Howard at Beale),23,72,Civic Center BART (7th at Market),23,821,23
843,6022.71648873073,67,Market at 10th,27,67,Market at 10th,27,312,531
843,724.596678529063,63,Howard at 2nd,19,65,Townsend at 7th,15,800,43
840,421.00238095238103,69,San Francisco Caltrain 2 (330 Townsend),23,61,2nd at Townsend,27,795,45
840,4709.715476190485,48,Embarcadero at Vallejo,15,48,Embarcadero at Vallejo,15,137,703
838,700.1646778042949,10,San Jose City Hall,15,2,San Jose Diridon Caltrain Station,27,801,37
836,1381.387559808612,60,Embarcadero at Sansome,15,69,San Francisco Caltrain 2 (330 Townsend),23,671,165
834,657.1306954436454,75,Mechanics Plaza (Market at Battery),19,54,Embarcadero at Bryant,15,781,53
832,514.8365384615382,82,Broadway St at Battery St,15,77,Market at Sansome,27,802,30
832,948.2800480769233,69,San Francisco Caltrain 2 (330 Townsend),23,75,Mechanics Plaza (Market at Battery),19,791,41
831,888.9049338146817,61,2nd at Townsend,27,41,Clay at Battery,15,724,107
830,602.9686746987953,69,San Francisco Caltrain 2 (330 Townsend),23,49,Spear at Folsom,19,810,20
827,3057.3337363966166,42,Davis at Jackson,15,42,Davis at Jackson,15,529,298
826,860.6912832929778,50,Harry Bridges Plaza (Ferry Building),23,57,5th at Howard,15,700,126
823,654.3863912515187,63,Howard at 2nd,19,77,Market at Sansome,27,783,40
822,9699.745742092457,71,Powell at Post (Union Square),19,71,Powell at Post (Union Square),19,53,769
820,597.4780487804879,50,Harry Bridges Plaza (Ferry Building),23,55,Temporary Transbay Terminal (Howard at Beale),23,788,32
818,942.8630806845956,75,Mechanics Plaza (Market at Battery),19,67,Market at 10th,27,713,105
817,898.4589963280291,66,South Van Ness at Market,19,55,Temporary Transbay Terminal (Howard at Beale),23,774,43
815,741.6478527607366,59,Golden Gate at Polk,23,70,San Francisco Caltrain (Townsend at 4th),19,776,39
814,724.0626535626542,67,Market at 10th,27,68,Yerba Buena Center of the Arts (3rd @ Howard),19,750,64
812,860.312807881774,9,Japantown,15,2,San Jose Diridon Caltrain Station,27,772,40
811,8944.06288532674,39,Powell Street BART,19,39,Powell Street BART,19,166,645
809,973.559950556242,55,Temporary Transbay Terminal (Howard at Beale),23,59,Golden Gate at Polk,23,800,9
807,1575.1511771995067,69,San Francisco Caltrain 2 (330 Townsend),23,60,Embarcadero at Sansome,15,628,179
805,1908.9006211180103,73,Grant Avenue at Columbus Avenue,19,60,Embarcadero at Sansome,15,352,453
804,625.3930348258716,2,San Jose Diridon Caltrain Station,27,13,St James Park,15,778,26
803,632.3848069738472,76,Market at 4th,19,64,2nd at South Park,15,722,81
801,503.05243445692867,45,Commercial at Montgomery,15,68,Yerba Buena Center of the Arts (3rd @ Howard),19,769,32
800,886.5412499999994,77,Market at Sansome,27,39,Powell Street BART,19,672,128
799,2596.889862327914,50,Harry Bridges Plaza (Ferry Building),23,73,Grant Avenue at Columbus Avenue,19,330,469
796,880.8655778894463,59,Golden Gate at Polk,23,55,Temporary Transbay Terminal (Howard at Beale),23,788,8
796,389.7349246231157,56,Beale at Market,19,49,Spear at Folsom,19,770,26
790,2864.0746835443033,60,Embarcadero at Sansome,15,73,Grant Avenue at Columbus Avenue,19,115,675
788,710.4581218274116,57,5th at Howard,15,65,Townsend at 7th,15,717,71
783,898.7624521072804,75,Mechanics Plaza (Market at Battery),19,71,Powell at Post (Union Square),19,650,133
780,4374.619230769223,54,Embarcadero at Bryant,15,54,Embarcadero at Bryant,15,322,458
780,691.11282051282,65,Townsend at 7th,15,62,2nd at Folsom,19,747,33
776,1486.3685567010311,39,Powell Street BART,19,50,Harry Bridges Plaza (Ferry Building),23,351,425
773,902.6545924967661,73,Grant Avenue at Columbus Avenue,19,74,Steuart at Market,23,694,79
773,1376.6106080206996,73,Grant Avenue at Columbus Avenue,19,39,Powell Street BART,19,615,158
770,1719.0831168831178,72,Civic Center BART (7th at Market),23,39,Powell Street BART,19,560,210
770,782.5779220779218,82,Broadway St at Battery St,15,61,2nd at Townsend,27,696,74
768,831.1927083333337,75,Mechanics Plaza (Market at Battery),19,69,San Francisco Caltrain 2 (330 Townsend),23,726,42
768,658.6744791666669,54,Embarcadero at Bryant,15,45,Commercial at Montgomery,15,739,29
766,705.0861618798963,69,San Francisco Caltrain 2 (330 Townsend),23,47,Post at Kearny,19,735,31
764,580.9790575916236,67,Market at 10th,27,57,5th at Howard,15,684,80
760,325.66710526315774,4,Santa Clara at Almaden,11,14,Arena Green / SAP Center,19,743,17
759,994.325428194994,42,Davis at Jackson,15,69,San Francisco Caltrain 2 (330 Townsend),23,726,33
756,3196.3439153439144,39,Powell Street BART,19,60,Embarcadero at Sansome,15,249,507
756,486.308201058201,77,Market at Sansome,27,82,Broadway St at Battery St,15,721,35
755,781.3403973509935,64,2nd at South Park,15,76,Market at 4th,19,665,90
755,725.3099337748353,68,Yerba Buena Center of the Arts (3rd @ Howard),19,67,Market at 10th,27,657,98
754,1253.5809018567618,49,Spear at Folsom,19,60,Embarcadero at Sansome,15,549,205
753,538.8313413014606,56,Beale at Market,19,54,Embarcadero at Bryant,15,698,55
749,1479.8411214953262,73,Grant Avenue at Columbus Avenue,19,50,Harry Bridges Plaza (Ferry Building),23,540,209
748,923.241978609626,57,5th at Howard,15,50,Harry Bridges Plaza (Ferry Building),23,574,174
747,1980.975903614459,72,Civic Center BART (7th at Market),23,60,Embarcadero at Sansome,15,546,201
744,848.9260752688167,64,2nd at South Park,15,74,Steuart at Market,23,683,61
743,1130.6204576043053,77,Market at Sansome,27,67,Market at 10th,27,637,106
741,1763.9460188933867,71,Powell at Post (Union Square),19,50,Harry Bridges Plaza (Ferry Building),23,282,459
740,1258.3608108108103,48,Embarcadero at Vallejo,15,61,2nd at Townsend,27,576,164
737,1008.8032564450463,61,2nd at Townsend,27,76,Market at 4th,19,628,109
733,714.6111869031379,54,Embarcadero at Bryant,15,65,Townsend at 7th,15,658,75
730,542.8821917808219,56,Beale at Market,19,64,2nd at South Park,15,684,46
727,599.9504814305365,45,Commercial at Montgomery,15,50,Harry Bridges Plaza (Ferry Building),23,646,81
727,710.7799174690507,42,Davis at Jackson,15,77,Market at Sansome,27,696,31
727,1176.2338376891346,65,Townsend at 7th,15,77,Market at Sansome,27,692,35
726,2033.809917355372,22,Redwood City Caltrain Station,25,25,Stanford in Redwood City,15,666,60
724,546.1049723756898,62,2nd at Folsom,19,39,Powell Street BART,19,652,72
724,883.0773480662981,68,Yerba Buena Center of the Arts (3rd @ Howard),19,50,Harry Bridges Plaza (Ferry Building),23,503,221
723,352.2282157676345,75,Mechanics Plaza (Market at Battery),19,45,Commercial at Montgomery,15,698,25
716,240.74581005586586,14,Arena Green / SAP Center,19,4,Santa Clara at Almaden,11,709,7
716,2580.751396648045,34,Palo Alto Caltrain Station,23,36,California Ave Caltrain Station,15,603,113
715,1354.5720279720288,71,Powell at Post (Union Square),19,67,Market at 10th,27,523,192
715,872.2937062937058,61,2nd at Townsend,27,75,Mechanics Plaza (Market at Battery),19,655,60
714,768.042016806723,62,2nd at Folsom,19,65,Townsend at 7th,15,667,47
710,861.8056338028173,65,Townsend at 7th,15,49,Spear at Folsom,19,672,38
709,1077.820874471086,73,Grant Avenue at Columbus Avenue,19,61,2nd at Townsend,27,618,91
706,1016.2181303116145,65,Townsend at 7th,15,74,Steuart at Market,23,656,50
705,915.150354609929,76,Market at 4th,19,61,2nd at Townsend,27,569,136
704,6286.995738636355,70,San Francisco Caltrain (Townsend at 4th),19,70,San Francisco Caltrain (Townsend at 4th),19,333,371
703,474.66287339971586,45,Commercial at Montgomery,15,75,Mechanics Plaza (Market at Battery),19,689,14
702,961.6581196581197,75,Mechanics Plaza (Market at Battery),19,50,Harry Bridges Plaza (Ferry Building),23,482,220
702,740.9131054131052,68,Yerba Buena Center of the Arts (3rd @ Howard),19,57,5th at Howard,15,632,70
702,720.1894586894587,61,2nd at Townsend,27,56,Beale at Market,19,616,86
697,846.896700143471,68,Yerba Buena Center of the Arts (3rd @ Howard),19,65,Townsend at 7th,15,629,68
697,945.7230989956955,65,Townsend at 7th,15,76,Market at 4th,19,642,55
697,8096.975609756094,28,Mountain View Caltrain Station,23,28,Mountain View Caltrain Station,23,179,518
696,762.856321839081,2,San Jose Diridon Caltrain Station,27,84,Ryland Park,15,670,26
690,637.4449275362325,72,Civic Center BART (7th at Market),23,55,Temporary Transbay Terminal (Howard at Beale),23,673,17
689,2560.9970972423794,60,Embarcadero at Sansome,15,71,Powell at Post (Union Square),19,113,576
685,815.8481751824822,76,Market at 4th,19,65,Townsend at 7th,15,620,65
684,907.2207602339181,75,Mechanics Plaza (Market at Battery),19,66,South Van Ness at Market,19,617,67
683,509.2986822840407,49,Spear at Folsom,19,45,Commercial at Montgomery,15,667,16
681,919.4464023494867,71,Powell at Post (Union Square),19,65,Townsend at 7th,15,609,72
678,491.01327433628364,64,2nd at South Park,15,47,Post at Kearny,19,643,35
677,1932.3293943870005,77,Market at Sansome,27,76,Market at 4th,19,522,155
675,948.4133333333345,77,Market at Sansome,27,65,Townsend at 7th,15,634,41
668,342.04491017964034,55,Temporary Transbay Terminal (Howard at Beale),23,75,Mechanics Plaza (Market at Battery),19,651,17
667,1177.1244377811083,74,Steuart at Market,23,76,Market at 4th,19,437,230
666,826.115615615616,45,Commercial at Montgomery,15,69,San Francisco Caltrain 2 (330 Townsend),23,631,35
663,1662.0361990950225,39,Powell Street BART,19,74,Steuart at Market,23,408,255
661,3676.558245083207,77,Market at Sansome,27,68,Yerba Buena Center of the Arts (3rd @ Howard),19,615,46
658,314.9772036474168,47,Post at Kearny,19,46,Washington at Kearny,15,577,81
654,487.9220183486236,63,Howard at 2nd,19,76,Market at 4th,19,611,43
654,288.7385321100916,42,Davis at Jackson,15,45,Commercial at Montgomery,15,641,13
649,1084.8335901386743,77,Market at Sansome,27,66,South Van Ness at Market,19,569,80
647,738.5888717156104,80,Santa Clara County Civic Center,15,84,Ryland Park,15,640,7
647,624.9489953632147,57,5th at Howard,15,76,Market at 4th,19,580,67
641,747.187207488299,57,5th at Howard,15,67,Market at 10th,27,539,102
641,727.5959438377528,2,San Jose Diridon Caltrain Station,27,3,San Jose Civic Center,15,515,126
640,804.971875,77,Market at Sansome,27,72,Civic Center BART (7th at Market),23,571,69
640,777.8562499999994,41,Clay at Battery,15,73,Grant Avenue at Columbus Avenue,19,533,107
640,1016.0203125000005,41,Clay at Battery,15,69,San Francisco Caltrain 2 (330 Townsend),23,609,31
640,990.5031250000003,69,San Francisco Caltrain 2 (330 Townsend),23,41,Clay at Battery,15,609,31
640,352.5031249999997,42,Davis at Jackson,15,55,Temporary Transbay Terminal (Howard at Beale),23,623,17
638,851.3401253918494,45,Commercial at Montgomery,15,76,Market at 4th,19,552,86
637,531.9733124018844,76,Market at 4th,19,56,Beale at Market,19,536,101
629,963.3116057233708,47,Post at Kearny,19,50,Harry Bridges Plaza (Ferry Building),23,504,125
629,1542.352941176471,56,Beale at Market,19,76,Market at 4th,19,512,117
628,643.3503184713377,66,South Van Ness at Market,19,47,Post at Kearny,19,606,22
627,1131.778309409889,69,San Francisco Caltrain 2 (330 Townsend),23,48,Embarcadero at Vallejo,15,531,96
627,978.4178628389168,25,Stanford in Redwood City,15,22,Redwood City Caltrain Station,25,580,47
625,6522.455999999998,73,Grant Avenue at Columbus Avenue,19,73,Grant Avenue at Columbus Avenue,19,117,508
624,733.1714743589739,54,Embarcadero at Bryant,15,41,Clay at Battery,15,561,63
623,839.9069020866767,67,Market at 10th,27,75,Mechanics Plaza (Market at Battery),19,569,54
623,767.1444622792944,55,Temporary Transbay Terminal (Howard at Beale),23,73,Grant Avenue at Columbus Avenue,19,585,38
621,2333.7971014492787,50,Harry Bridges Plaza (Ferry Building),23,71,Powell at Post (Union Square),19,209,412
619,767.0468497576736,50,Harry Bridges Plaza (Ferry Building),23,45,Commercial at Montgomery,15,539,80
619,947.4264943457194,70,San Francisco Caltrain (Townsend at 4th),19,59,Golden Gate at Polk,23,585,34
615,590.8601626016259,45,Commercial at Montgomery,15,39,Powell Street BART,19,554,61
615,653.3089430894303,57,5th at Howard,15,77,Market at Sansome,27,567,48
615,966.9382113821146,2,San Jose Diridon Caltrain Station,27,10,San Jose City Hall,15,568,47
613,858.3017944535077,69,San Francisco Caltrain 2 (330 Townsend),23,45,Commercial at Montgomery,15,590,23
613,611.646003262643,74,Steuart at Market,23,75,Mechanics Plaza (Market at Battery),19,556,57
612,667.6486928104573,59,Golden Gate at Polk,23,77,Market at Sansome,27,555,57
611,677.6317512274958,60,Embarcadero at Sansome,15,49,Spear at Folsom,19,514,97
609,377.5106732348111,47,Post at Kearny,19,64,2nd at South Park,15,568,41
604,1182.504966887418,73,Grant Avenue at Columbus Avenue,19,71,Powell at Post (Union Square),19,337,267
604,693.9503311258273,58,San Francisco City Hall,19,69,San Francisco Caltrain 2 (330 Townsend),23,570,34
598,595.9397993311037,55,Temporary Transbay Terminal (Howard at Beale),23,77,Market at Sansome,27,576,22
597,240.89614740368503,42,Davis at Jackson,15,56,Beale at Market,19,582,15
595,2637.515966386552,65,Townsend at 7th,15,65,Townsend at 7th,15,427,168
595,530.9428571428574,51,Embarcadero at Folsom,19,74,Steuart at Market,23,554,41
595,508.18319327731103,84,Ryland Park,15,80,Santa Clara County Civic Center,15,575,20
594,759.4932659932659,71,Powell at Post (Union Square),19,77,Market at Sansome,27,483,111
592,756.9189189189186,41,Clay at Battery,15,39,Powell Street BART,19,532,60
592,248.46790540540567,82,Broadway St at Battery St,15,41,Clay at Battery,15,574,18
592,904.1537162162157,61,2nd at Townsend,27,54,Embarcadero at Bryant,15,479,113
587,711.4957410562181,73,Grant Avenue at Columbus Avenue,19,75,Mechanics Plaza (Market at Battery),19,552,35
587,786.6252129471902,67,Market at 10th,27,56,Beale at Market,19,531,56
586,863.0068259385669,57,5th at Howard,15,39,Powell Street BART,19,468,118
586,428.4709897610922,48,Embarcadero at Vallejo,15,56,Beale at Market,19,534,52
585,1428.5521367521378,39,Powell Street BART,19,58,San Francisco City Hall,19,418,167
582,544.7250859106524,61,2nd at Townsend,27,68,Yerba Buena Center of the Arts (3rd @ Howard),19,479,103
576,1150.027777777776,55,Temporary Transbay Terminal (Howard at Beale),23,39,Powell Street BART,19,524,52
576,333.13888888888886,55,Temporary Transbay Terminal (Howard at Beale),23,54,Embarcadero at Bryant,15,554,22
574,2777.4790940766543,50,Harry Bridges Plaza (Ferry Building),23,67,Market at 10th,27,424,150
572,537.0541958041957,77,Market at Sansome,27,51,Embarcadero at Folsom,19,516,56
572,1461.0349650349656,67,Market at 10th,27,50,Harry Bridges Plaza (Ferry Building),23,354,218
572,527.2709790209793,75,Mechanics Plaza (Market at Battery),19,51,Embarcadero at Folsom,19,540,32
571,737.7583187390544,46,Washington at Kearny,15,39,Powell Street BART,19,499,72
571,321.56917688266213,64,2nd at South Park,15,62,2nd at Folsom,19,550,21
570,812.0315789473682,74,Steuart at Market,23,68,Yerba Buena Center of the Arts (3rd @ Howard),19,440,130
570,355.7859649122804,75,Mechanics Plaza (Market at Battery),19,55,Temporary Transbay Terminal (Howard at Beale),23,565,5
565,1029.9380530973444,72,Civic Center BART (7th at Market),23,74,Steuart at Market,23,415,150
564,1505.797872340425,70,San Francisco Caltrain (Townsend at 4th),19,73,Grant Avenue at Columbus Avenue,19,476,88
564,768.3102836879438,76,Market at 4th,19,57,5th at Howard,15,505,59
564,1082.5957446808509,64,2nd at South Park,15,48,Embarcadero at Vallejo,15,506,58
563,933.2149200710487,71,Powell at Post (Union Square),19,74,Steuart at Market,23,291,272
562,701.8185053380787,73,Grant Avenue at Columbus Avenue,19,49,Spear at Folsom,19,539,23
561,630.9839572192512,68,Yerba Buena Center of the Arts (3rd @ Howard),19,45,Commercial at Montgomery,15,534,27
560,562.9821428571427,65,Townsend at 7th,15,57,5th at Howard,15,504,56
558,2138.4480286738335,46,Washington at Kearny,15,60,Embarcadero at Sansome,15,214,344
558,439.5627240143369,55,Temporary Transbay Terminal (Howard at Beale),23,62,2nd at Folsom,19,538,20
557,1345.7522441651702,76,Market at 4th,19,75,Mechanics Plaza (Market at Battery),19,448,109
556,936.3776978417264,51,Embarcadero at Folsom,19,50,Harry Bridges Plaza (Ferry Building),23,449,107
555,817.6846846846845,39,Powell Street BART,19,56,Beale at Market,19,481,74
554,828.3610108303252,61,2nd at Townsend,27,82,Broadway St at Battery St,15,473,81
554,449.04693140794234,64,2nd at South Park,15,49,Spear at Folsom,19,529,25
554,745.6696750902531,75,Mechanics Plaza (Market at Battery),19,72,Civic Center BART (7th at Market),23,489,65
553,1035.4954792043407,51,Embarcadero at Folsom,19,65,Townsend at 7th,15,503,50
552,7418.737318840578,34,Palo Alto Caltrain Station,23,34,Palo Alto Caltrain Station,23,94,458
551,556.5771324863879,39,Powell Street BART,19,57,5th at Howard,15,485,66
549,693.6885245901638,62,2nd at Folsom,19,76,Market at 4th,19,495,54
548,838.6368613138691,67,Market at 10th,27,55,Temporary Transbay Terminal (Howard at Beale),23,529,19
548,1451.494525547445,76,Market at 4th,19,73,Grant Avenue at Columbus Avenue,19,361,187
547,8598.14990859233,72,Civic Center BART (7th at Market),23,72,Civic Center BART (7th at Market),23,164,383
544,541.8547794117643,39,Powell Street BART,19,62,2nd at Folsom,19,499,45
544,620.7775735294114,71,Powell at Post (Union Square),19,42,Davis at Jackson,15,510,34
543,485.7532228360954,42,Davis at Jackson,15,49,Spear at Folsom,19,524,19
540,778.7629629629627,39,Powell Street BART,19,46,Washington at Kearny,15,469,71
540,404.41296296296287,49,Spear at Folsom,19,64,2nd at South Park,15,505,35
540,1085.4907407407409,56,Beale at Market,19,39,Powell Street BART,19,449,91
539,324.0204081632649,55,Temporary Transbay Terminal (Howard at Beale),23,74,Steuart at Market,23,524,15
538,987.6226765799254,48,Embarcadero at Vallejo,15,69,San Francisco Caltrain 2 (330 Townsend),23,485,53
536,597.6660447761204,51,Embarcadero at Folsom,19,77,Market at Sansome,27,500,36
535,856.6186915887848,68,Yerba Buena Center of the Arts (3rd @ Howard),19,74,Steuart at Market,23,374,161
534,1167.2509363295887,50,Harry Bridges Plaza (Ferry Building),23,47,Post at Kearny,19,436,98
532,544.1390977443615,56,Beale at Market,19,42,Davis at Jackson,15,521,11
531,447.5461393596988,64,2nd at South Park,15,68,Yerba Buena Center of the Arts (3rd @ Howard),19,468,63
531,5097.9114877589445,77,Market at Sansome,27,77,Market at Sansome,27,223,308
530,819.1999999999997,16,SJSU - San Salvador at 9th,15,2,San Jose Diridon Caltrain Station,27,486,44
530,493.0245283018869,57,5th at Howard,15,72,Civic Center BART (7th at Market),23,483,47
529,815.5614366729687,75,Mechanics Plaza (Market at Battery),19,61,2nd at Townsend,27,475,54
529,1084.0623818525514,3,San Jose Civic Center,15,2,San Jose Diridon Caltrain Station,27,417,112
528,519.5643939393941,64,2nd at South Park,15,61,2nd at Townsend,27,482,46
527,843.6660341555979,2,San Jose Diridon Caltrain Station,27,16,SJSU - San Salvador at 9th,15,470,57
526,599.5760456273771,62,2nd at Folsom,19,41,Clay at Battery,15,499,27
526,3411.1311787072223,69,San Francisco Caltrain 2 (330 Townsend),23,69,San Francisco Caltrain 2 (330 Townsend),23,374,152
526,631.9638783269961,76,Market at 4th,19,49,Spear at Folsom,19,467,59
525,557.622857142858,77,Market at Sansome,27,57,5th at Howard,15,485,40
524,395.3187022900764,49,Spear at Folsom,19,75,Mechanics Plaza (Market at Battery),19,484,40
523,1117.1567877629057,65,Townsend at 7th,15,59,Golden Gate at Polk,23,487,36
521,598.6583493282151,75,Mechanics Plaza (Market at Battery),19,42,Davis at Jackson,15,506,15
519,518.1445086705204,57,5th at Howard,15,63,Howard at 2nd,19,484,35
519,1874.9922928709063,60,Embarcadero at Sansome,15,72,Civic Center BART (7th at Market),23,336,183
519,1195.9980732177273,70,San Francisco Caltrain (Townsend at 4th),19,71,Powell at Post (Union Square),19,399,120
516,825.5426356589139,67,Market at 10th,27,64,2nd at South Park,15,477,39
514,5816.122568093387,41,Clay at Battery,15,41,Clay at Battery,15,155,359
513,1242.5224171539976,58,San Francisco City Hall,19,39,Powell Street BART,19,369,144
511,330.2583170254399,10,San Jose City Hall,15,8,San Salvador at 1st,15,496,15
511,853.1996086105679,60,Embarcadero at Sansome,15,45,Commercial at Montgomery,15,347,164
510,601.7372549019611,71,Powell at Post (Union Square),19,64,2nd at South Park,15,434,76
510,2096.0117647058814,64,2nd at South Park,15,64,2nd at South Park,15,387,123
510,1227.711764705881,73,Grant Avenue at Columbus Avenue,19,69,San Francisco Caltrain 2 (330 Townsend),23,467,43
509,9183.703339882115,3,San Jose Civic Center,15,3,San Jose Civic Center,15,26,483
508,393.0413385826774,54,Embarcadero at Bryant,15,49,Spear at Folsom,19,483,25
507,638.1025641025641,71,Powell at Post (Union Square),19,56,Beale at Market,19,447,60
506,858.7193675889332,66,South Van Ness at Market,19,56,Beale at Market,19,458,48
506,833.4584980237148,56,Beale at Market,19,50,Harry Bridges Plaza (Ferry Building),23,383,123
506,1575.956521739131,76,Market at 4th,19,42,Davis at Jackson,15,462,44
504,996.9563492063493,34,Palo Alto Caltrain Station,23,38,Park at Olive,15,449,55
504,5962.083333333338,66,South Van Ness at Market,19,66,South Van Ness at Market,19,185,319
503,1329.55467196819,71,Powell at Post (Union Square),19,73,Grant Avenue at Columbus Avenue,19,281,222
502,487.26693227091624,75,Mechanics Plaza (Market at Battery),19,74,Steuart at Market,23,434,68
499,486.08617234468977,51,Embarcadero at Folsom,19,64,2nd at South Park,15,449,50
498,918.0200803212855,41,Clay at Battery,15,50,Harry Bridges Plaza (Ferry Building),23,332,166
496,961.9737903225803,60,Embarcadero at Sansome,15,82,Broadway St at Battery St,15,346,150
490,1243.648979591837,60,Embarcadero at Sansome,15,46,Washington at Kearny,15,177,313
489,686.8895705521472,64,2nd at South Park,15,57,5th at Howard,15,436,53
488,644.0204918032784,50,Harry Bridges Plaza (Ferry Building),23,49,Spear at Folsom,19,426,62
488,1089.1004098360665,71,Powell at Post (Union Square),19,75,Mechanics Plaza (Market at Battery),19,419,69
487,752.4702258726893,65,Townsend at 7th,15,68,Yerba Buena Center of the Arts (3rd @ Howard),19,423,64
487,2004.9117043121157,82,Broadway St at Battery St,15,60,Embarcadero at Sansome,15,283,204
487,1467.3367556468165,39,Powell Street BART,19,59,Golden Gate at Polk,23,338,149
486,542.8312757201645,77,Market at Sansome,27,63,Howard at 2nd,19,457,29
486,2057.7798353909448,60,Embarcadero at Sansome,15,66,South Van Ness at Market,19,350,136
485,478.1195876288658,68,Yerba Buena Center of the Arts (3rd @ Howard),19,64,2nd at South Park,15,397,88
485,1525.917525773197,66,South Van Ness at Market,19,60,Embarcadero at Sansome,15,408,77
484,443.72933884297504,72,Civic Center BART (7th at Market),23,57,5th at Howard,15,425,59
484,517.1487603305795,74,Steuart at Market,23,42,Davis at Jackson,15,439,45
484,465.5475206611572,54,Embarcadero at Bryant,15,56,Beale at Market,19,446,38
484,645.3698347107434,47,Post at Kearny,19,74,Steuart at Market,23,390,94
484,3376.5640495867788,51,Embarcadero at Folsom,19,51,Embarcadero at Folsom,19,223,261
482,418.68879668049806,62,2nd at Folsom,19,63,Howard at 2nd,19,466,16
479,723.8810020876832,58,San Francisco City Hall,19,70,San Francisco Caltrain (Townsend at 4th),19,455,24
479,491.55949895615873,59,Golden Gate at Polk,23,67,Market at 10th,27,431,48
478,505.9769874476988,77,Market at Sansome,27,56,Beale at Market,19,439,39
477,529.4444444444445,45,Commercial at Montgomery,15,49,Spear at Folsom,19,465,12
476,734.510504201681,59,Golden Gate at Polk,23,68,Yerba Buena Center of the Arts (3rd @ Howard),19,441,35
473,518.6828752642705,77,Market at Sansome,27,49,Spear at Folsom,19,443,30
472,909.813559322034,67,Market at 10th,27,71,Powell at Post (Union Square),19,348,124
472,809.760593220339,59,Golden Gate at Polk,23,39,Powell Street BART,19,363,109
471,6883.197452229299,57,5th at Howard,15,57,5th at Howard,15,155,316
471,1139.5732484076445,56,Beale at Market,19,73,Grant Avenue at Columbus Avenue,19,409,62
471,831.4309978768574,65,Townsend at 7th,15,51,Embarcadero at Folsom,19,436,35
469,2085.695095948828,57,5th at Howard,15,60,Embarcadero at Sansome,15,240,229
468,778.5299145299144,64,2nd at South Park,15,39,Powell Street BART,19,394,74
468,849.08547008547,65,Townsend at 7th,15,54,Embarcadero at Bryant,15,415,53
465,1019.4817204301077,56,Beale at Market,19,67,Market at 10th,27,420,45
465,729.7892473118277,69,San Francisco Caltrain 2 (330 Townsend),23,46,Washington at Kearny,15,454,11
465,1222.6688172043018,50,Harry Bridges Plaza (Ferry Building),23,42,Davis at Jackson,15,390,75
465,2037.701075268816,60,Embarcadero at Sansome,15,59,Golden Gate at Polk,23,388,77
463,471.77105831533504,62,2nd at Folsom,19,57,5th at Howard,15,416,47
462,666.8939393939397,42,Davis at Jackson,15,76,Market at 4th,19,422,40
460,852.8804347826083,66,South Van Ness at Market,19,75,Mechanics Plaza (Market at Battery),19,436,24
454,670.9317180616742,49,Spear at Folsom,19,68,Yerba Buena Center of the Arts (3rd @ Howard),19,401,53
454,720.9361233480179,48,Embarcadero at Vallejo,15,64,2nd at South Park,15,414,40
454,738.6255506607931,69,San Francisco Caltrain 2 (330 Townsend),23,54,Embarcadero at Bryant,15,393,61
452,732.5309734513276,68,Yerba Buena Center of the Arts (3rd @ Howard),19,77,Market at Sansome,27,407,45
450,1142.2688888888895,60,Embarcadero at Sansome,15,63,Howard at 2nd,19,263,187
449,293.57906458797333,8,San Salvador at 1st,15,11,MLK Library,19,436,13
449,1285.7371937639205,72,Civic Center BART (7th at Market),23,59,Golden Gate at Polk,23,401,48
448,773.4732142857146,82,Broadway St at Battery St,15,50,Harry Bridges Plaza (Ferry Building),23,364,84
448,591.8660714285718,41,Clay at Battery,15,76,Market at 4th,19,353,95
448,2154.1294642857138,33,Rengstorff Avenue / California Street,15,28,Mountain View Caltrain Station,23,385,63
447,623.4049217002232,76,Market at 4th,19,63,Howard at 2nd,19,412,35
447,827.5928411633112,47,Post at Kearny,19,67,Market at 10th,27,393,54
447,391.5950782997762,54,Embarcadero at Bryant,15,55,Temporary Transbay Terminal (Howard at Beale),23,432,15
446,4909.145739910322,68,Yerba Buena Center of the Arts (3rd @ Howard),19,68,Yerba Buena Center of the Arts (3rd @ Howard),19,97,349
446,945.3991031390125,50,Harry Bridges Plaza (Ferry Building),23,82,Broadway St at Battery St,15,343,103
445,678.1505617977523,82,Broadway St at Battery St,15,54,Embarcadero at Bryant,15,402,43
443,1067.966139954854,58,San Francisco City Hall,19,76,Market at 4th,19,306,137
443,554.627539503386,75,Mechanics Plaza (Market at Battery),19,82,Broadway St at Battery St,15,428,15
440,686.5022727272731,39,Powell Street BART,19,55,Temporary Transbay Terminal (Howard at Beale),23,422,18
440,1571.8704545454539,71,Powell at Post (Union Square),19,39,Powell Street BART,19,304,136
439,655.9840546697038,55,Temporary Transbay Terminal (Howard at Beale),23,56,Beale at Market,19,418,21
438,496.0068493150686,62,2nd at Folsom,19,74,Steuart at Market,23,403,35
437,1282.5011441647598,59,Golden Gate at Polk,23,74,Steuart at Market,23,371,66
436,644.5206422018354,76,Market at 4th,19,62,2nd at Folsom,19,366,70
436,4114.568807339447,75,Mechanics Plaza (Market at Battery),19,75,Mechanics Plaza (Market at Battery),19,193,243
434,1000.2511520737324,76,Market at 4th,19,54,Embarcadero at Bryant,15,365,69
433,1242.653579676674,74,Steuart at Market,23,73,Grant Avenue at Columbus Avenue,19,288,145
433,672.0046189376441,68,Yerba Buena Center of the Arts (3rd @ Howard),19,61,2nd at Townsend,27,329,104
430,480.5186046511628,77,Market at Sansome,27,41,Clay at Battery,15,391,39
430,799.241860465116,67,Market at 10th,27,62,2nd at Folsom,19,394,36
430,587.7023255813955,49,Spear at Folsom,19,42,Davis at Jackson,15,409,21
429,578.1282051282053,49,Spear at Folsom,19,57,5th at Howard,15,390,39
428,742.0443925233654,76,Market at 4th,19,45,Commercial at Montgomery,15,377,51
428,874.5677570093466,47,Post at Kearny,19,65,Townsend at 7th,15,414,14
426,471.9436619718309,49,Spear at Folsom,19,63,Howard at 2nd,19,392,34
426,1067.7605633802823,45,Commercial at Montgomery,15,60,Embarcadero at Sansome,15,270,156
423,425.2836879432621,45,Commercial at Montgomery,15,56,Beale at Market,19,405,18
423,978.7210401891256,74,Steuart at Market,23,39,Powell Street BART,19,286,137
423,759.7825059101656,74,Steuart at Market,23,57,5th at Howard,15,347,76
420,875.1285714285716,70,San Francisco Caltrain (Townsend at 4th),19,46,Washington at Kearny,15,389,31
420,2290.32857142857,39,Powell Street BART,19,76,Market at 4th,19,283,137
420,572.0238095238097,62,2nd at Folsom,19,45,Commercial at Montgomery,15,395,25
419,586.8019093078759,59,Golden Gate at Polk,23,72,Civic Center BART (7th at Market),23,386,33
416,503.0769230769231,55,Temporary Transbay Terminal (Howard at Beale),23,42,Davis at Jackson,15,399,17
415,2424.2674698795167,47,Post at Kearny,19,60,Embarcadero at Sansome,15,187,228
414,1499.533816425121,73,Grant Avenue at Columbus Avenue,19,67,Market at 10th,27,327,87
412,1456.9538834951456,39,Powell Street BART,19,75,Mechanics Plaza (Market at Battery),19,340,72
411,404.4890510948906,41,Clay at Battery,15,77,Market at Sansome,27,381,30
411,1120.4817518248176,68,Yerba Buena Center of the Arts (3rd @ Howard),19,39,Powell Street BART,19,313,98
410,425.1317073170732,75,Mechanics Plaza (Market at Battery),19,49,Spear at Folsom,19,383,27
410,1280.8878048780475,28,Mountain View Caltrain Station,23,33,Rengstorff Avenue / California Street,15,343,67
406,849.3916256157638,67,Market at 10th,27,63,Howard at 2nd,19,368,38
406,679.9433497536944,59,Golden Gate at Polk,23,76,Market at 4th,19,323,83
404,1396.7772277227737,45,Commercial at Montgomery,15,71,Powell at Post (Union Square),19,289,115
403,900.406947890819,71,Powell at Post (Union Square),19,46,Washington at Kearny,15,318,85
403,633.9875930521091,49,Spear at Folsom,19,54,Embarcadero at Bryant,15,371,32
403,870.2803970223317,64,2nd at South Park,15,71,Powell at Post (Union Square),19,300,103
403,425.07940446650116,41,Clay at Battery,15,82,Broadway St at Battery St,15,381,22
400,1041.3799999999992,51,Embarcadero at Folsom,19,48,Embarcadero at Vallejo,15,309,91
400,597.8025,65,Townsend at 7th,15,64,2nd at South Park,15,358,42
400,920.8824999999998,61,2nd at Townsend,27,45,Commercial at Montgomery,15,344,56
399,4699.521303258146,58,San Francisco City Hall,19,58,San Francisco City Hall,19,125,274
399,409.609022556391,51,Embarcadero at Folsom,19,63,Howard at 2nd,19,365,34
399,880.9097744360898,47,Post at Kearny,19,73,Grant Avenue at Columbus Avenue,19,309,90
397,1786.0277078085635,6,San Pedro Square,15,9,Japantown,15,296,101
397,701.9471032745588,9,Japantown,15,6,San Pedro Square,15,302,95
397,752.7758186397991,51,Embarcadero at Folsom,19,68,Yerba Buena Center of the Arts (3rd @ Howard),19,342,55
396,561.2247474747471,64,2nd at South Park,15,75,Mechanics Plaza (Market at Battery),19,374,22
396,1407.5883838383852,61,2nd at Townsend,27,71,Powell at Post (Union Square),19,282,114
396,617.0505050505049,71,Powell at Post (Union Square),19,82,Broadway St at Battery St,15,369,27
396,1242.5227272727273,66,South Van Ness at Market,19,74,Steuart at Market,23,283,113
396,571.063131313131,63,Howard at 2nd,19,51,Embarcadero at Folsom,19,357,39
395,686.6810126582275,61,2nd at Townsend,27,47,Post at Kearny,19,331,64
394,1041.0634517766498,62,2nd at Folsom,19,67,Market at 10th,27,366,28
393,817.12213740458,71,Powell at Post (Union Square),19,61,2nd at Townsend,27,311,82
393,546.7684478371509,51,Embarcadero at Folsom,19,46,Washington at Kearny,15,384,9
393,1464.007633587786,50,Harry Bridges Plaza (Ferry Building),23,41,Clay at Battery,15,270,123
393,722.7302798982187,72,Civic Center BART (7th at Market),23,56,Beale at Market,19,346,47
392,3443.1632653061224,49,Spear at Folsom,19,49,Spear at Folsom,19,219,173
391,467.61381074168816,51,Embarcadero at Folsom,19,75,Mechanics Plaza (Market at Battery),19,367,24
390,589.8153846153843,64,2nd at South Park,15,51,Embarcadero at Folsom,19,363,27
389,968.8277634961441,77,Market at Sansome,27,54,Embarcadero at Bryant,15,342,47
389,1105.0771208226229,63,Howard at 2nd,19,66,South Van Ness at Market,19,351,38
388,413.88144329896903,57,5th at Howard,15,62,2nd at Folsom,19,356,32
387,703.519379844961,71,Powell at Post (Union Square),19,68,Yerba Buena Center of the Arts (3rd @ Howard),19,237,150
387,1757.276485788114,63,Howard at 2nd,19,67,Market at 10th,27,336,51
387,2253.3591731266147,38,Park at Olive,15,34,Palo Alto Caltrain Station,23,321,66
386,475.282383419689,61,2nd at Townsend,27,64,2nd at South Park,15,352,34
386,920.8652849740939,71,Powell at Post (Union Square),19,72,Civic Center BART (7th at Market),23,252,134
385,1585.0285714285696,63,Howard at 2nd,19,60,Embarcadero at Sansome,15,211,174
385,751.9142857142856,48,Embarcadero at Vallejo,15,51,Embarcadero at Folsom,19,297,88
384,536.5598958333334,57,5th at Howard,15,64,2nd at South Park,15,337,47
384,1054.726562499999,73,Grant Avenue at Columbus Avenue,19,47,Post at Kearny,19,300,84
384,1870.5156250000002,67,Market at 10th,27,61,2nd at Townsend,27,342,42
383,598.1122715404704,22,Redwood City Caltrain Station,25,26,Redwood City Medical Center,15,362,21
383,759.1827676240206,65,Townsend at 7th,15,47,Post at Kearny,19,376,7
381,862.0078740157483,71,Powell at Post (Union Square),19,57,5th at Howard,15,313,68
380,873.1842105263157,59,Golden Gate at Polk,23,57,5th at Howard,15,331,49
379,804.1108179419526,42,Davis at Jackson,15,50,Harry Bridges Plaza (Ferry Building),23,323,56
379,503.58575197889206,4,Santa Clara at Almaden,11,12,SJSU 4th at San Carlos,19,362,17
379,653.6068601583115,57,5th at Howard,15,49,Spear at Folsom,19,353,26
377,1552.0132625994702,60,Embarcadero at Sansome,15,68,Yerba Buena Center of the Arts (3rd @ Howard),19,171,206
377,849.5968169761276,45,Commercial at Montgomery,15,61,2nd at Townsend,27,296,81
376,629.859042553192,73,Grant Avenue at Columbus Avenue,19,42,Davis at Jackson,15,345,31
376,683.0186170212763,54,Embarcadero at Bryant,15,82,Broadway St at Battery St,15,338,38
375,557.8720000000003,71,Powell at Post (Union Square),19,47,Post at Kearny,19,307,68
375,709.0533333333336,59,Golden Gate at Polk,23,66,South Van Ness at Market,19,312,63
374,964.7032085561486,49,Spear at Folsom,19,76,Market at 4th,19,327,47
374,1430.1925133689845,73,Grant Avenue at Columbus Avenue,19,65,Townsend at 7th,15,338,36
372,556.5268817204305,74,Steuart at Market,23,41,Clay at Battery,15,342,30
371,1110.7008086253372,61,2nd at Townsend,27,57,5th at Howard,15,319,52
371,553.7762803234502,57,5th at Howard,15,45,Commercial at Montgomery,15,356,15
370,905.7783783783783,69,San Francisco Caltrain 2 (330 Townsend),23,58,San Francisco City Hall,19,344,26
369,222.8807588075881,82,Broadway St at Battery St,15,42,Davis at Jackson,15,355,14
367,486.858310626703,57,5th at Howard,15,47,Post at Kearny,19,343,24
366,1492.6612021857925,57,5th at Howard,15,66,South Van Ness at Market,19,276,90
365,968.7506849315068,64,2nd at South Park,15,67,Market at 10th,27,315,50
364,4009.434065934068,55,Temporary Transbay Terminal (Howard at Beale),23,55,Temporary Transbay Terminal (Howard at Beale),23,232,132
363,676.6666666666665,8,San Salvador at 1st,15,2,San Jose Diridon Caltrain Station,27,329,34
363,653.9531680440774,58,San Francisco City Hall,19,65,Townsend at 7th,15,329,34
363,987.5261707988975,73,Grant Avenue at Columbus Avenue,19,64,2nd at South Park,15,319,44
362,590.4972375690609,76,Market at 4th,19,41,Clay at Battery,15,286,76
362,3563.356353591162,76,Market at 4th,19,39,Powell Street BART,19,214,148
362,1451.160220994476,67,Market at 10th,27,59,Golden Gate at Polk,23,308,54
362,390.21823204419917,49,Spear at Folsom,19,56,Beale at Market,19,333,29
361,827.6177285318555,46,Washington at Kearny,15,77,Market at Sansome,27,301,60
361,1530.9418282548484,66,South Van Ness at Market,19,67,Market at 10th,27,301,60
360,1493.4888888888893,64,2nd at South Park,15,60,Embarcadero at Sansome,15,222,138
360,801.7777777777777,82,Broadway St at Battery St,15,76,Market at 4th,19,314,46
358,1123.6871508379877,68,Yerba Buena Center of the Arts (3rd @ Howard),19,66,South Van Ness at Market,19,263,95
358,1250.6061452513961,39,Powell Street BART,19,61,2nd at Townsend,27,260,98
357,1316.9019607843125,63,Howard at 2nd,19,39,Powell Street BART,19,301,56
357,1696.6302521008392,37,Cowper at University,11,35,University and Emerson,11,259,98
357,1120.6862745098038,74,Steuart at Market,23,77,Market at Sansome,27,296,61
355,696.433802816901,66,South Van Ness at Market,19,57,5th at Howard,15,296,59
354,1291.833333333333,58,San Francisco City Hall,19,77,Market at Sansome,27,296,58
354,894.5819209039548,16,SJSU - San Salvador at 9th,15,7,Paseo de San Antonio,15,318,36
353,1055.0849858356953,69,San Francisco Caltrain 2 (330 Townsend),23,71,Powell at Post (Union Square),19,305,48
352,492.48295454545445,62,2nd at Folsom,19,68,Yerba Buena Center of the Arts (3rd @ Howard),19,309,43
352,1498.4488636363633,72,Civic Center BART (7th at Market),23,50,Harry Bridges Plaza (Ferry Building),23,173,179
351,530.5726495726499,55,Temporary Transbay Terminal (Howard at Beale),23,49,Spear at Folsom,19,341,10
350,1431.9771428571432,60,Embarcadero at Sansome,15,57,5th at Howard,15,180,170
350,560.5457142857144,62,2nd at Folsom,19,51,Embarcadero at Folsom,19,329,21
350,747.1314285714292,45,Commercial at Montgomery,15,57,5th at Howard,15,323,27
349,643.4899713467051,76,Market at 4th,19,46,Washington at Kearny,15,276,73
348,3288.7126436781596,67,Market at 10th,27,60,Embarcadero at Sansome,15,182,166
348,733.6005747126443,67,Market at 10th,27,46,Washington at Kearny,15,319,29
347,859.8674351585017,42,Davis at Jackson,15,71,Powell at Post (Union Square),19,291,56
346,751.7745664739884,72,Civic Center BART (7th at Market),23,75,Mechanics Plaza (Market at Battery),19,306,40
346,718.7774566473981,2,San Jose Diridon Caltrain Station,27,8,San Salvador at 1st,15,309,37
346,1440.5751445086705,66,South Van Ness at Market,19,50,Harry Bridges Plaza (Ferry Building),23,206,140
346,3632.421965317918,68,Yerba Buena Center of the Arts (3rd @ Howard),19,60,Embarcadero at Sansome,15,102,244
346,830.2687861271676,45,Commercial at Montgomery,15,64,2nd at South Park,15,306,40
345,3332.034782608696,36,California Ave Caltrain Station,15,34,Palo Alto Caltrain Station,23,238,107
344,934.6337209302327,82,Broadway St at Battery St,15,71,Powell at Post (Union Square),19,294,50
344,1022.3139534883716,64,2nd at South Park,15,46,Washington at Kearny,15,321,23
343,925.8717201166181,51,Embarcadero at Folsom,19,73,Grant Avenue at Columbus Avenue,19,294,49
343,1076.195335276969,66,South Van Ness at Market,19,64,2nd at South Park,15,321,22
342,336.3888888888888,42,Davis at Jackson,15,82,Broadway St at Battery St,15,333,9
341,6059.457478005865,56,Beale at Market,19,56,Beale at Market,19,118,223
341,1177.7683284457478,46,Washington at Kearny,15,50,Harry Bridges Plaza (Ferry Building),23,202,139
340,347.7735294117645,47,Post at Kearny,19,63,Howard at 2nd,19,324,16
339,574.250737463127,71,Powell at Post (Union Square),19,45,Commercial at Montgomery,15,291,48
339,1287.5811209439535,74,Steuart at Market,23,71,Powell at Post (Union Square),19,178,161
338,342.0976331360947,41,Clay at Battery,15,75,Mechanics Plaza (Market at Battery),19,310,28
337,1551.3709198813046,77,Market at Sansome,27,48,Embarcadero at Vallejo,15,187,150
335,623.2985074626864,42,Davis at Jackson,15,75,Mechanics Plaza (Market at Battery),19,314,21
334,908.4461077844313,63,Howard at 2nd,19,71,Powell at Post (Union Square),19,279,55
333,2021.4444444444464,36,California Ave Caltrain Station,15,35,University and Emerson,11,169,164
330,566.3242424242421,45,Commercial at Montgomery,15,82,Broadway St at Battery St,15,318,12
329,4114.729483282675,63,Howard at 2nd,19,63,Howard at 2nd,19,191,138
328,720.2713414634145,59,Golden Gate at Polk,23,56,Beale at Market,19,312,16
325,678.1907692307689,71,Powell at Post (Union Square),19,62,2nd at Folsom,19,290,35
325,725.4799999999992,63,Howard at 2nd,19,68,Yerba Buena Center of the Arts (3rd @ Howard),19,269,56
325,2800.255384615385,67,Market at 10th,27,66,South Van Ness at Market,19,210,115
325,2074.9538461538473,59,Golden Gate at Polk,23,60,Embarcadero at Sansome,15,251,74
324,420.1697530864194,47,Post at Kearny,19,45,Commercial at Montgomery,15,304,20
324,1418.262345679013,61,2nd at Townsend,27,73,Grant Avenue at Columbus Avenue,19,209,115
323,2543.712074303406,76,Market at 4th,19,48,Embarcadero at Vallejo,15,98,225
323,2443.2136222910217,74,Steuart at Market,23,67,Market at 10th,27,227,96
323,422.8823529411766,42,Davis at Jackson,15,51,Embarcadero at Folsom,19,307,16
322,306.226708074534,74,Steuart at Market,23,55,Temporary Transbay Terminal (Howard at Beale),23,306,16
322,464.6304347826086,45,Commercial at Montgomery,15,63,Howard at 2nd,19,299,23
321,1222.0467289719627,68,Yerba Buena Center of the Arts (3rd @ Howard),19,73,Grant Avenue at Columbus Avenue,19,225,96
321,496.0872274143303,49,Spear at Folsom,19,62,2nd at Folsom,19,305,16
319,891.9498432601883,77,Market at Sansome,27,59,Golden Gate at Polk,23,281,38
318,1493.3836477987427,73,Grant Avenue at Columbus Avenue,19,72,Civic Center BART (7th at Market),23,248,70
318,1067.562893081761,66,South Van Ness at Market,19,49,Spear at Folsom,19,310,8
316,2717.702531645568,48,Embarcadero at Vallejo,15,76,Market at 4th,19,133,183
316,651.6360759493671,42,Davis at Jackson,15,54,Embarcadero at Bryant,15,286,30
315,2949.180952380953,60,Embarcadero at Sansome,15,67,Market at 10th,27,162,153
315,1121.9714285714294,50,Harry Bridges Plaza (Ferry Building),23,51,Embarcadero at Folsom,19,232,83
315,1607.7904761904767,60,Embarcadero at Sansome,15,47,Post at Kearny,19,157,158
315,1515.6793650793657,76,Market at 4th,19,58,San Francisco City Hall,19,217,98
314,906.2547770700639,46,Washington at Kearny,15,76,Market at 4th,19,206,108
314,5554.949044585988,46,Washington at Kearny,15,46,Washington at Kearny,15,40,274
314,4030.3184713375813,82,Broadway St at Battery St,15,82,Broadway St at Battery St,15,162,152
313,395.7156549520767,47,Post at Kearny,19,55,Temporary Transbay Terminal (Howard at Beale),23,304,9
313,479.65495207667726,55,Temporary Transbay Terminal (Howard at Beale),23,47,Post at Kearny,19,300,13
313,856.7220447284348,51,Embarcadero at Folsom,19,42,Davis at Jackson,15,282,31
312,10024.214743589737,36,California Ave Caltrain Station,15,36,California Ave Caltrain Station,15,61,251
312,695.0160256410253,64,2nd at South Park,15,41,Clay at Battery,15,288,24
309,1302.7831715210352,56,Beale at Market,19,77,Market at Sansome,27,269,40
307,780.6612377850169,66,South Van Ness at Market,19,59,Golden Gate at Polk,23,267,40
307,3027.547231270359,39,Powell Street BART,19,73,Grant Avenue at Columbus Avenue,19,192,115
306,545.813725490196,75,Mechanics Plaza (Market at Battery),19,64,2nd at South Park,15,280,26
305,729.2459016393441,68,Yerba Buena Center of the Arts (3rd @ Howard),19,55,Temporary Transbay Terminal (Howard at Beale),23,281,24
305,651.4590163934429,13,St James Park,15,6,San Pedro Square,15,280,25
304,1295.572368421053,46,Washington at Kearny,15,75,Mechanics Plaza (Market at Battery),19,264,40
304,418.39144736842127,62,2nd at Folsom,19,54,Embarcadero at Bryant,15,287,17
304,1233.677631578947,56,Beale at Market,19,71,Powell at Post (Union Square),19,220,84
303,554.2904290429045,7,Paseo de San Antonio,15,16,SJSU - San Salvador at 9th,15,258,45
303,3661.4488448844886,14,Arena Green / SAP Center,19,14,Arena Green / SAP Center,19,93,210
300,1651.4100000000008,71,Powell at Post (Union Square),19,66,South Van Ness at Market,19,141,159
299,978.6287625418057,58,San Francisco City Hall,19,66,South Van Ness at Market,19,235,64
299,494.1939799331105,33,Rengstorff Avenue / California Street,15,29,San Antonio Caltrain Station,23,271,28
299,759.5016722408028,63,Howard at 2nd,19,54,Embarcadero at Bryant,15,263,36
298,478.74161073825513,12,SJSU 4th at San Carlos,19,4,Santa Clara at Almaden,11,279,19
298,3891.204697986575,45,Commercial at Montgomery,15,45,Commercial at Montgomery,15,153,145
297,578.7373737373741,62,2nd at Folsom,19,46,Washington at Kearny,15,282,15
296,483.3614864864866,41,Clay at Battery,15,49,Spear at Folsom,19,263,33
295,1234.4440677966106,49,Spear at Folsom,19,67,Market at 10th,27,270,25
295,619.1322033898308,73,Grant Avenue at Columbus Avenue,19,63,Howard at 2nd,19,255,40
294,715.8061224489795,75,Mechanics Plaza (Market at Battery),19,57,5th at Howard,15,251,43
294,1093.197278911563,67,Market at 10th,27,49,Spear at Folsom,19,254,40
294,6626.136054421768,4,Santa Clara at Almaden,11,4,Santa Clara at Almaden,11,110,184
293,853.5255972696241,64,2nd at South Park,15,45,Commercial at Montgomery,15,271,22
293,447.71672354948765,41,Clay at Battery,15,63,Howard at 2nd,19,278,15
292,520.7089041095888,29,San Antonio Caltrain Station,23,33,Rengstorff Avenue / California Street,15,253,39
292,662.7226027397257,54,Embarcadero at Bryant,15,42,Davis at Jackson,15,265,27
290,688.5827586206901,41,Clay at Battery,15,54,Embarcadero at Bryant,15,234,56
288,1514.20138888889,49,Spear at Folsom,19,77,Market at Sansome,27,258,30
288,300.2777777777778,56,Beale at Market,19,51,Embarcadero at Folsom,19,276,12
288,443.2187499999998,45,Commercial at Montgomery,15,47,Post at Kearny,19,262,26
288,845.4062500000003,73,Grant Avenue at Columbus Avenue,19,68,Yerba Buena Center of the Arts (3rd @ Howard),19,202,86
288,409.1527777777776,42,Davis at Jackson,15,74,Steuart at Market,23,272,16
288,889.3402777777777,47,Post at Kearny,19,66,South Van Ness at Market,19,243,45
288,822.2534722222217,72,Civic Center BART (7th at Market),23,64,2nd at South Park,15,252,36
286,977.548951048951,46,Washington at Kearny,15,55,Temporary Transbay Terminal (Howard at Beale),23,281,5
286,2441.3951048951044,72,Civic Center BART (7th at Market),23,73,Grant Avenue at Columbus Avenue,19,213,73
285,3218.407017543859,62,2nd at Folsom,19,62,2nd at Folsom,19,135,150
285,808.2105263157896,64,2nd at South Park,15,56,Beale at Market,19,269,16
285,249.2456140350877,6,San Pedro Square,15,13,St James Park,15,267,18
285,609.9052631578944,62,2nd at Folsom,19,56,Beale at Market,19,267,18
284,7266.352112676058,9,Japantown,15,9,Japantown,15,129,155
284,2962.760563380282,71,Powell at Post (Union Square),19,76,Market at 4th,19,154,130
284,2793.352112676056,50,Harry Bridges Plaza (Ferry Building),23,46,Washington at Kearny,15,93,191
284,1783.954225352112,62,2nd at Folsom,19,60,Embarcadero at Sansome,15,118,166
284,1226.4929577464782,42,Davis at Jackson,15,73,Grant Avenue at Columbus Avenue,19,208,76
283,5497.802120141343,2,San Jose Diridon Caltrain Station,27,12,SJSU 4th at San Carlos,19,253,30
283,666.6855123674916,46,Washington at Kearny,15,56,Beale at Market,19,266,17
282,534.8404255319148,68,Yerba Buena Center of the Arts (3rd @ Howard),19,49,Spear at Folsom,19,238,44
282,811.1843971631206,66,South Van Ness at Market,19,63,Howard at 2nd,19,267,15
281,1588.985765124555,72,Civic Center BART (7th at Market),23,71,Powell at Post (Union Square),19,148,133
281,1229.9145907473298,39,Powell Street BART,19,45,Commercial at Montgomery,15,235,46
280,1351.5035714285698,46,Washington at Kearny,15,70,San Francisco Caltrain (Townsend at 4th),19,241,39
280,1108.5535714285725,51,Embarcadero at Folsom,19,76,Market at 4th,19,213,67
280,2237.167857142857,77,Market at Sansome,27,71,Powell at Post (Union Square),19,180,100
280,6861.035714285711,59,Golden Gate at Polk,23,59,Golden Gate at Polk,23,74,206
279,1120.9498207885308,67,Market at 10th,27,45,Commercial at Montgomery,15,249,30
278,1069.1582733812957,47,Post at Kearny,19,61,2nd at Townsend,27,218,60
278,912.1187050359714,61,2nd at Townsend,27,39,Powell Street BART,19,199,79
278,496.2230215827338,75,Mechanics Plaza (Market at Battery),19,46,Washington at Kearny,15,260,18
278,1348.4892086330944,76,Market at 4th,19,59,Golden Gate at Polk,23,193,85
278,7061.392086330937,6,San Pedro Square,15,6,San Pedro Square,15,66,212
277,1136.9061371841149,74,Steuart at Market,23,72,Civic Center BART (7th at Market),23,216,61
277,541.1480144404333,83,Mezes Park,15,22,Redwood City Caltrain Station,25,270,7
276,1998.2717391304336,64,2nd at South Park,15,73,Grant Avenue at Columbus Avenue,19,197,79
276,1016.521739130434,28,Mountain View Caltrain Station,23,31,San Antonio Shopping Center,15,232,44
274,650.1386861313866,54,Embarcadero at Bryant,15,63,Howard at 2nd,19,248,26
273,851.8754578754578,42,Davis at Jackson,15,48,Embarcadero at Vallejo,15,220,53
273,1678.6007326007327,7,Paseo de San Antonio,15,9,Japantown,15,226,47
273,557.7728937728934,49,Spear at Folsom,19,82,Broadway St at Battery St,15,260,13
272,763.2757352941175,63,Howard at 2nd,19,49,Spear at Folsom,19,248,24
272,730.2426470588233,63,Howard at 2nd,19,55,Temporary Transbay Terminal (Howard at Beale),23,252,20
271,749.5461254612549,47,Post at Kearny,19,75,Mechanics Plaza (Market at Battery),19,253,18
271,832.7970479704798,41,Clay at Battery,15,71,Powell at Post (Union Square),19,175,96
271,657.509225092251,47,Post at Kearny,19,42,Davis at Jackson,15,264,7
270,696.4740740740743,74,Steuart at Market,23,47,Post at Kearny,19,210,60
268,1579.921641791044,73,Grant Avenue at Columbus Avenue,19,62,2nd at Folsom,19,238,30
268,1548.9477611940304,62,2nd at Folsom,19,73,Grant Avenue at Columbus Avenue,19,218,50
268,984.4850746268658,49,Spear at Folsom,19,48,Embarcadero at Vallejo,15,195,73
268,929.4328358208954,49,Spear at Folsom,19,41,Clay at Battery,15,242,26
268,1067.8059701492532,70,San Francisco Caltrain (Townsend at 4th),19,58,San Francisco City Hall,19,242,26
267,709.7265917603,55,Temporary Transbay Terminal (Howard at Beale),23,46,Washington at Kearny,15,255,12
267,941.3745318352063,62,2nd at Folsom,19,71,Powell at Post (Union Square),19,210,57
266,885.7969924812029,47,Post at Kearny,19,39,Powell Street BART,19,223,43
265,1071.192452830189,72,Civic Center BART (7th at Market),23,46,Washington at Kearny,15,234,31
264,2641.477272727271,48,Embarcadero at Vallejo,15,73,Grant Avenue at Columbus Avenue,19,39,225
263,952.2015209125476,62,2nd at Folsom,19,72,Civic Center BART (7th at Market),23,236,27
263,1005.4866920152087,46,Washington at Kearny,15,64,2nd at South Park,15,246,17
263,939.3422053231943,67,Market at 10th,27,42,Davis at Jackson,15,249,14
262,895.9885496183205,72,Civic Center BART (7th at Market),23,41,Clay at Battery,15,233,29
261,3955.950191570881,10,San Jose City Hall,15,10,San Jose City Hall,15,186,75
261,2992.789272030652,50,Harry Bridges Plaza (Ferry Building),23,66,South Van Ness at Market,19,123,138
259,2732.6911196911183,60,Embarcadero at Sansome,15,65,Townsend at 7th,15,197,62
258,7727.589147286822,2,San Jose Diridon Caltrain Station,27,2,San Jose Diridon Caltrain Station,27,108,150
258,1264.6007751937973,68,Yerba Buena Center of the Arts (3rd @ Howard),19,72,Civic Center BART (7th at Market),23,167,91
258,1790.6860465116274,35,University and Emerson,11,36,California Ave Caltrain Station,15,121,137
258,1014.9147286821702,45,Commercial at Montgomery,15,67,Market at 10th,27,209,49
257,631.0622568093385,47,Post at Kearny,19,82,Broadway St at Battery St,15,227,30
255,915.5803921568628,66,South Van Ness at Market,19,45,Commercial at Montgomery,15,244,11
254,595.629921259842,64,2nd at South Park,15,54,Embarcadero at Bryant,15,206,48
254,1260.6062992125985,57,5th at Howard,15,61,2nd at Townsend,27,209,45
254,8074.759842519679,27,Mountain View City Hall,15,27,Mountain View City Hall,15,85,169
253,1353.1422924901194,66,South Van Ness at Market,19,58,San Francisco City Hall,19,220,33
251,1706.0876494023908,60,Embarcadero at Sansome,15,64,2nd at South Park,15,164,87
251,992.1474103585659,77,Market at Sansome,27,46,Washington at Kearny,15,208,43
251,774.4780876494021,71,Powell at Post (Union Square),19,49,Spear at Folsom,19,204,47
250,1111.1639999999995,66,South Van Ness at Market,19,68,Yerba Buena Center of the Arts (3rd @ Howard),19,213,37
249,4122.361445783131,39,Powell Street BART,19,71,Powell at Post (Union Square),19,121,128
249,762.9718875502006,39,Powell Street BART,19,64,2nd at South Park,15,196,53
248,1032.5080645161281,77,Market at Sansome,27,58,San Francisco City Hall,19,210,38
247,469.19838056680163,39,Powell Street BART,19,47,Post at Kearny,19,212,35
247,1048.777327935223,54,Embarcadero at Bryant,15,77,Market at Sansome,27,207,40
246,1643.878048780489,14,Arena Green / SAP Center,19,6,San Pedro Square,15,203,43
246,2028.1016260162605,54,Embarcadero at Bryant,15,76,Market at 4th,19,171,75
245,639.6040816326531,74,Steuart at Market,23,46,Washington at Kearny,15,192,53
245,1027.3224489795923,56,Beale at Market,19,65,Townsend at 7th,15,221,24
244,999.5286885245904,76,Market at 4th,19,82,Broadway St at Battery St,15,199,45
243,548.3621399176957,45,Commercial at Montgomery,15,51,Embarcadero at Folsom,19,226,17
242,1233.9710743801656,63,Howard at 2nd,19,72,Civic Center BART (7th at Market),23,212,30
241,451.5186721991701,47,Post at Kearny,19,57,5th at Howard,15,229,12
241,613.4315352697096,75,Mechanics Plaza (Market at Battery),19,47,Post at Kearny,19,207,34
240,1671.1499999999992,67,Market at 10th,27,73,Grant Avenue at Columbus Avenue,19,167,73
240,674.7708333333328,76,Market at 4th,19,51,Embarcadero at Folsom,19,195,45
239,704.7196652719665,72,Civic Center BART (7th at Market),23,47,Post at Kearny,19,191,48
239,672.7405857740587,57,5th at Howard,15,56,Beale at Market,19,212,27
238,799.878151260504,11,MLK Library,19,9,Japantown,15,186,52
238,858.7857142857144,71,Powell at Post (Union Square),19,55,Temporary Transbay Terminal (Howard at Beale),23,216,22
238,900.8655462184876,71,Powell at Post (Union Square),19,41,Clay at Battery,15,150,88
238,1160.8277310924375,76,Market at 4th,19,68,Yerba Buena Center of the Arts (3rd @ Howard),19,188,50
237,734.5316455696204,51,Embarcadero at Folsom,19,57,5th at Howard,15,183,54
237,1020.5443037974682,31,San Antonio Shopping Center,15,28,Mountain View Caltrain Station,23,196,41
235,1099.4042553191498,46,Washington at Kearny,15,69,San Francisco Caltrain 2 (330 Townsend),23,221,14
235,472.20425531914924,41,Clay at Battery,15,56,Beale at Market,19,212,23
235,2456.07659574468,73,Grant Avenue at Columbus Avenue,19,66,South Van Ness at Market,19,134,101
234,466.32905982905993,56,Beale at Market,19,63,Howard at 2nd,19,214,20
233,673.8583690987118,41,Clay at Battery,15,64,2nd at South Park,15,202,31
233,6188.785407725318,11,MLK Library,19,11,MLK Library,19,79,154
233,1393.8540772532185,49,Spear at Folsom,19,73,Grant Avenue at Columbus Avenue,19,199,34
232,8785.767241379312,37,Cowper at University,11,37,Cowper at University,11,59,173
232,1794.2327586206898,58,San Francisco City Hall,19,67,Market at 10th,27,158,74
231,681.1515151515148,42,Davis at Jackson,15,47,Post at Kearny,19,209,22
231,3349.8961038961043,39,Powell Street BART,19,48,Embarcadero at Vallejo,15,63,168
230,919.5565217391306,65,Townsend at 7th,15,56,Beale at Market,19,217,13
230,1170.0956521739126,45,Commercial at Montgomery,15,58,San Francisco City Hall,19,219,11
229,1777.262008733625,74,Steuart at Market,23,59,Golden Gate at Polk,23,199,30
229,1990.9606986899587,61,2nd at Townsend,27,67,Market at 10th,27,158,71
229,1225.6375545851524,56,Beale at Market,19,66,South Van Ness at Market,19,189,40
229,4719.593886462882,58,San Francisco City Hall,19,60,Embarcadero at Sansome,15,91,138
229,6156.069868995632,32,Castro Street and El Camino Real,11,32,Castro Street and El Camino Real,11,80,149
228,1222.4780701754387,57,5th at Howard,15,71,Powell at Post (Union Square),19,124,104
228,2320.241228070176,48,Embarcadero at Vallejo,15,75,Mechanics Plaza (Market at Battery),19,138,90
228,632.2850877192986,63,Howard at 2nd,19,41,Clay at Battery,15,209,19
228,938.2324561403508,72,Civic Center BART (7th at Market),23,45,Commercial at Montgomery,15,206,22
228,610.0657894736845,39,Powell Street BART,19,63,Howard at 2nd,19,196,32
227,1467.493392070484,75,Mechanics Plaza (Market at Battery),19,48,Embarcadero at Vallejo,15,155,72
227,979.0308370044053,55,Temporary Transbay Terminal (Howard at Beale),23,71,Powell at Post (Union Square),19,189,38
226,1247.3716814159288,75,Mechanics Plaza (Market at Battery),19,73,Grant Avenue at Columbus Avenue,19,172,54
226,926.3938053097345,68,Yerba Buena Center of the Arts (3rd @ Howard),19,71,Powell at Post (Union Square),19,95,131
226,1080.0176991150445,45,Commercial at Montgomery,15,66,South Van Ness at Market,19,196,30
225,1059.8177777777794,39,Powell Street BART,19,41,Clay at Battery,15,174,51
225,1596.2933333333337,80,Santa Clara County Civic Center,15,6,San Pedro Square,15,218,7
225,5872.364444444443,47,Post at Kearny,19,47,Post at Kearny,19,64,161
225,666.7333333333336,47,Post at Kearny,19,72,Civic Center BART (7th at Market),23,188,37
225,364.61777777777786,22,Redwood City Caltrain Station,25,83,Mezes Park,15,216,9
224,749.5178571428573,64,2nd at South Park,15,42,Davis at Jackson,15,204,20
223,5582.511210762326,50,Harry Bridges Plaza (Ferry Building),23,72,Civic Center BART (7th at Market),23,107,116
223,449.85201793721956,63,Howard at 2nd,19,47,Post at Kearny,19,201,22
223,293.09865470852026,49,Spear at Folsom,19,55,Temporary Transbay Terminal (Howard at Beale),23,220,3
222,710.9369369369368,7,Paseo de San Antonio,15,8,San Salvador at 1st,15,186,36
221,2213.4434389140283,50,Harry Bridges Plaza (Ferry Building),23,56,Beale at Market,19,170,51
221,860.9728506787333,49,Spear at Folsom,19,39,Powell Street BART,19,176,45
219,3540.8036529680376,76,Market at 4th,19,71,Powell at Post (Union Square),19,68,151
219,552.8310502283106,6,San Pedro Square,15,84,Ryland Park,15,190,29
218,461.71100917431176,54,Embarcadero at Bryant,15,62,2nd at Folsom,19,201,17
218,477.8623853211009,82,Broadway St at Battery St,15,49,Spear at Folsom,19,213,5
218,1563.4816513761477,65,Townsend at 7th,15,71,Powell at Post (Union Square),19,167,51
217,472.33179723502303,45,Commercial at Montgomery,15,74,Steuart at Market,23,178,39
217,2748.963133640552,26,Redwood City Medical Center,15,22,Redwood City Caltrain Station,25,203,14
216,402.9259259259258,82,Broadway St at Battery St,15,51,Embarcadero at Folsom,19,202,14
216,819.0231481481482,48,Embarcadero at Vallejo,15,42,Davis at Jackson,15,170,46
216,855.6944444444443,57,5th at Howard,15,75,Mechanics Plaza (Market at Battery),19,179,37
215,1659.4976744186054,58,San Francisco City Hall,19,50,Harry Bridges Plaza (Ferry Building),23,122,93
213,897.6431924882626,46,Washington at Kearny,15,47,Post at Kearny,19,149,64
212,993.4292452830189,41,Clay at Battery,15,72,Civic Center BART (7th at Market),23,185,27
212,787.7641509433962,9,Japantown,15,11,MLK Library,19,171,41
212,4692.04716981132,8,San Salvador at 1st,15,8,San Salvador at 1st,15,79,133
212,1054.806603773585,56,Beale at Market,19,72,Civic Center BART (7th at Market),23,172,40
211,426.9573459715643,84,Ryland Park,15,6,San Pedro Square,15,172,39
211,1123.7014218009474,64,2nd at South Park,15,66,South Van Ness at Market,19,181,30
211,733.8483412322279,57,5th at Howard,15,59,Golden Gate at Polk,23,171,40
211,1996.1990521327018,45,Commercial at Montgomery,15,73,Grant Avenue at Columbus Avenue,19,151,60
211,1341.2985781990524,64,2nd at South Park,15,72,Civic Center BART (7th at Market),23,178,33
210,2983.766666666668,42,Davis at Jackson,15,39,Powell Street BART,19,173,37
210,665.3999999999996,51,Embarcadero at Folsom,19,45,Commercial at Montgomery,15,186,24
210,982.8047619047618,46,Washington at Kearny,15,67,Market at 10th,27,180,30
209,443.91866028708125,75,Mechanics Plaza (Market at Battery),19,63,Howard at 2nd,19,196,13
209,520.574162679426,56,Beale at Market,19,68,Yerba Buena Center of the Arts (3rd @ Howard),19,184,25
209,530.5215311004788,75,Mechanics Plaza (Market at Battery),19,68,Yerba Buena Center of the Arts (3rd @ Howard),19,169,40
208,781.7211538461539,42,Davis at Jackson,15,63,Howard at 2nd,19,197,11
207,407.8695652173913,8,San Salvador at 1st,15,7,Paseo de San Antonio,15,177,30
207,762.6521739130434,68,Yerba Buena Center of the Arts (3rd @ Howard),19,54,Embarcadero at Bryant,15,157,50
207,866.3671497584543,54,Embarcadero at Bryant,15,68,Yerba Buena Center of the Arts (3rd @ Howard),19,164,43
206,555.1310679611647,41,Clay at Battery,15,62,2nd at Folsom,19,190,16
206,672.1310679611651,48,Embarcadero at Vallejo,15,49,Spear at Folsom,19,153,53
206,924.626213592233,59,Golden Gate at Polk,23,47,Post at Kearny,19,185,21
206,565.7864077669901,51,Embarcadero at Folsom,19,82,Broadway St at Battery St,15,183,23
206,1193.3592233009708,66,South Van Ness at Market,19,61,2nd at Townsend,27,170,36
205,2138.804878048781,35,University and Emerson,11,37,Cowper at University,11,138,67
205,849.7219512195121,41,Clay at Battery,15,74,Steuart at Market,23,162,43
205,915.4926829268293,45,Commercial at Montgomery,15,72,Civic Center BART (7th at Market),23,183,22
204,4164.132352941176,7,Paseo de San Antonio,15,7,Paseo de San Antonio,15,67,137
204,1829.828431372549,65,Townsend at 7th,15,60,Embarcadero at Sansome,15,137,67
204,952.1274509803918,56,Beale at Market,19,57,5th at Howard,15,162,42
204,2334.6225490196084,74,Steuart at Market,23,66,South Van Ness at Market,19,131,73
203,537.039408866995,63,Howard at 2nd,19,45,Commercial at Montgomery,15,191,12
202,687.9455445544553,72,Civic Center BART (7th at Market),23,62,2nd at Folsom,19,179,23
202,631.2178217821782,62,2nd at Folsom,19,47,Post at Kearny,19,181,21
202,3535.262376237623,48,Embarcadero at Vallejo,15,39,Powell Street BART,19,66,136
201,2189.8358208955224,71,Powell at Post (Union Square),19,59,Golden Gate at Polk,23,92,109
200,1247.0900000000006,57,5th at Howard,15,68,Yerba Buena Center of the Arts (3rd @ Howard),19,157,43
200,1415.2700000000004,82,Broadway St at Battery St,15,72,Civic Center BART (7th at Market),23,189,11
200,499.625,62,2nd at Folsom,19,75,Mechanics Plaza (Market at Battery),19,188,12
200,1195.4199999999996,47,Post at Kearny,19,76,Market at 4th,19,164,36
200,1195.39,73,Grant Avenue at Columbus Avenue,19,54,Embarcadero at Bryant,15,136,64
200,772.5000000000001,41,Clay at Battery,15,51,Embarcadero at Folsom,19,175,25
200,755.59,75,Mechanics Plaza (Market at Battery),19,41,Clay at Battery,15,173,27
199,1326.6633165829141,41,Clay at Battery,15,48,Embarcadero at Vallejo,15,117,82
199,3026.773869346732,71,Powell at Post (Union Square),19,48,Embarcadero at Vallejo,15,62,137
199,679.1155778894469,57,5th at Howard,15,41,Clay at Battery,15,176,23
199,1092.502512562814,73,Grant Avenue at Columbus Avenue,19,46,Washington at Kearny,15,153,46
198,591.232323232323,82,Broadway St at Battery St,15,47,Post at Kearny,19,181,17
197,376.32487309644665,55,Temporary Transbay Terminal (Howard at Beale),23,51,Embarcadero at Folsom,19,191,6
197,1070.56345177665,41,Clay at Battery,15,57,5th at Howard,15,162,35
197,624.9035532994923,72,Civic Center BART (7th at Market),23,63,Howard at 2nd,19,175,22
196,1398.1683673469392,61,2nd at Townsend,27,66,South Van Ness at Market,19,130,66
196,9852.581632653064,22,Redwood City Caltrain Station,25,22,Redwood City Caltrain Station,25,66,130
196,1188.4285714285713,68,Yerba Buena Center of the Arts (3rd @ Howard),19,76,Market at 4th,19,148,48
195,1204.210256410256,65,Townsend at 7th,15,48,Embarcadero at Vallejo,15,158,37
194,1085.6185567010311,72,Civic Center BART (7th at Market),23,61,2nd at Townsend,27,159,35
194,1168.1443298969073,65,Townsend at 7th,15,45,Commercial at Montgomery,15,183,11
194,1233.0309278350512,72,Civic Center BART (7th at Market),23,58,San Francisco City Hall,19,152,42
194,1046.5824742268042,58,San Francisco City Hall,19,75,Mechanics Plaza (Market at Battery),19,163,31
194,1521.7783505154634,45,Commercial at Montgomery,15,65,Townsend at 7th,15,174,20
193,1052.113989637306,49,Spear at Folsom,19,71,Powell at Post (Union Square),19,140,53
192,1035.1875000000002,72,Civic Center BART (7th at Market),23,68,Yerba Buena Center of the Arts (3rd @ Howard),19,128,64
192,1110.5729166666663,66,South Van Ness at Market,19,51,Embarcadero at Folsom,19,182,10
192,749.213541666667,68,Yerba Buena Center of the Arts (3rd @ Howard),19,56,Beale at Market,19,151,41
192,1301.807291666667,63,Howard at 2nd,19,73,Grant Avenue at Columbus Avenue,19,133,59
191,1100.769633507854,74,Steuart at Market,23,62,2nd at Folsom,19,154,37
191,1481.1465968586376,59,Golden Gate at Polk,23,48,Embarcadero at Vallejo,15,160,31
191,1289.2356020942395,9,Japantown,15,10,San Jose City Hall,15,134,57
190,1090.921052631579,59,Golden Gate at Polk,23,50,Harry Bridges Plaza (Ferry Building),23,122,68
190,1942.110526315789,46,Washington at Kearny,15,71,Powell at Post (Union Square),19,63,127
190,2109.010526315789,61,2nd at Townsend,27,72,Civic Center BART (7th at Market),23,131,59
189,1278.9523809523805,66,South Van Ness at Market,19,71,Powell at Post (Union Square),19,84,105
189,5184.037037037037,30,Evelyn Park and Ride,15,30,Evelyn Park and Ride,15,34,155
189,874.6984126984125,42,Davis at Jackson,15,64,2nd at South Park,15,171,18
189,637.5873015873012,46,Washington at Kearny,15,51,Embarcadero at Folsom,19,166,23
189,729.1904761904763,12,SJSU 4th at San Carlos,19,2,San Jose Diridon Caltrain Station,27,152,37
189,833.3333333333331,56,Beale at Market,19,47,Post at Kearny,19,171,18
187,1935.12834224599,57,5th at Howard,15,48,Embarcadero at Vallejo,15,120,67
187,516.9786096256685,68,Yerba Buena Center of the Arts (3rd @ Howard),19,47,Post at Kearny,19,135,52
187,602.1871657754011,7,Paseo de San Antonio,15,6,San Pedro Square,15,142,45
187,2467.475935828877,75,Mechanics Plaza (Market at Battery),19,77,Market at Sansome,27,134,53
186,765.3870967741938,84,Ryland Park,15,3,San Jose Civic Center,15,150,36
186,3267.290322580643,58,San Francisco City Hall,19,72,Civic Center BART (7th at Market),23,126,60
186,409.28494623655894,47,Post at Kearney,19,46,Washington at Kearney,15,164,22
185,1196.8270270270275,73,Grant Avenue at Columbus Avenue,19,57,5th at Howard,15,143,42
184,3438.9619565217395,48,Embarcadero at Vallejo,15,71,Powell at Post (Union Square),19,40,144
183,1250.5355191256829,9,Japantown,15,84,Ryland Park,15,164,19
183,444.5464480874316,82,Broadway St at Battery St,15,45,Commercial at Montgomery,15,166,17
182,2362.203296703298,61,2nd at Townsend,27,46,Washington at Kearny,15,126,56
180,682.9666666666669,57,5th at Howard,15,51,Embarcadero at Folsom,19,150,30
180,3763.744444444446,77,Market at Sansome,27,75,Mechanics Plaza (Market at Battery),19,85,95
180,840.9000000000003,75,Mechanics Plaza (Market at Battery),19,59,Golden Gate at Polk,23,156,24
180,1781.8499999999995,37,Cowper at University,11,36,California Ave Caltrain Station,15,127,53
179,1374.4860335195538,51,Embarcadero at Folsom,19,56,Beale at Market,19,169,10
178,2611.0898876404494,50,Harry Bridges Plaza (Ferry Building),23,58,San Francisco City Hall,19,110,68
178,2071.8146067415723,48,Embarcadero at Vallejo,15,77,Market at Sansome,27,112,66
178,707.4494382022468,54,Embarcadero at Bryant,15,64,2nd at South Park,15,152,26
177,898.5254237288137,41,Clay at Battery,15,68,Yerba Buena Center of the Arts (3rd @ Howard),19,108,69
177,1646.4576271186438,63,Howard at 2nd,19,48,Embarcadero at Vallejo,15,98,79
177,17114.367231638418,29,San Antonio Caltrain Station,23,29,San Antonio Caltrain Station,23,31,146
177,1459.4180790960459,11,MLK Library,19,16,SJSU - San Salvador at 9th,15,124,53
177,377.42937853107367,47,Post at Kearny,19,41,Clay at Battery,15,158,19
177,739.519774011299,6,San Pedro Square,15,7,Paseo de San Antonio,15,123,54
176,675.8977272727273,22,Redwood City Caltrain Station,25,21,Franklin at Maple,15,154,22
176,1227.227272727273,49,Spear at Folsom,19,66,South Van Ness at Market,19,158,18
175,1188.0285714285708,56,Beale at Market,19,74,Steuart at Market,23,104,71
175,755.5085714285713,68,Yerba Buena Center of the Arts (3rd @ Howard),19,51,Embarcadero at Folsom,19,126,49
175,2288.005714285716,41,Clay at Battery,15,47,Post at Kearny,19,151,24
175,3836.2914285714296,59,Golden Gate at Polk,23,71,Powell at Post (Union Square),19,79,96
174,2653.8448275862065,58,San Francisco City Hall,19,71,Powell at Post (Union Square),19,65,109
174,801.2241379310342,46,Washington at Kearny,15,57,5th at Howard,15,144,30
174,1162.4942528735635,13,St James Park,15,9,Japantown,15,139,35
174,4563.327586206898,69,San Francisco Caltrain 2 (330 Townsend),23,70,San Francisco Caltrain (Townsend at 4th),19,117,57
174,922.6839080459773,62,2nd at Folsom,19,42,Davis at Jackson,15,165,9
174,1195.2816091954014,65,Townsend at 7th,15,42,Davis at Jackson,15,160,14
174,1471.7356321839075,16,SJSU - San Salvador at 9th,15,8,San Salvador at 1st,15,141,33
173,4807.676300578035,50,Harry Bridges Plaza (Ferry Building),23,59,Golden Gate at Polk,23,92,81
173,4644.086705202313,74,Steuart at Market,23,50,Harry Bridges Plaza (Ferry Building),23,83,90
173,1086.6936416184967,6,San Pedro Square,15,3,San Jose Civic Center,15,45,128
173,1026.8497109826596,73,Grant Avenue at Columbus Avenue,19,82,Broadway St at Battery St,15,146,27
172,505.01744186046477,10,San Jose City Hall,15,7,Paseo de San Antonio,15,154,18
171,852.684210526316,68,Yerba Buena Center of the Arts (3rd @ Howard),19,46,Washington at Kearny,15,118,53
171,740.9415204678362,39,Powell Street BART,19,49,Spear at Folsom,19,129,42
171,2569.7426900584787,56,Beale at Market,19,59,Golden Gate at Polk,23,157,14
171,1191.5087719298244,8,San Salvador at 1st,15,6,San Pedro Square,15,110,61
170,4128.747058823528,50,Harry Bridges Plaza (Ferry Building),23,74,Steuart at Market,23,69,101
170,802.441176470588,82,Broadway St at Battery St,15,39,Powell Street BART,19,155,15
170,989.2235294117648,71,Powell at Post (Union Square),19,58,San Francisco City Hall,19,94,76
170,875.0588235294118,82,Broadway St at Battery St,15,57,5th at Howard,15,148,22
169,1349.319526627218,10,San Jose City Hall,15,9,Japantown,15,126,43
169,2295.497041420117,57,5th at Howard,15,73,Grant Avenue at Columbus Avenue,19,102,67
169,1297.8994082840238,48,Embarcadero at Vallejo,15,65,Townsend at 7th,15,144,25
168,731.4107142857139,68,Yerba Buena Center of the Arts (3rd @ Howard),19,41,Clay at Battery,15,114,54
168,8443.369047619048,84,Ryland Park,15,84,Ryland Park,15,64,104
168,2115.678571428572,28,Mountain View Caltrain Station,23,29,San Antonio Caltrain Station,23,90,78
167,3196.335329341318,46,Washington at Kearny,15,73,Grant Avenue at Columbus Avenue,19,60,107
167,970.0838323353291,59,Golden Gate at Polk,23,49,Spear at Folsom,19,163,4
167,898.9101796407189,63,Howard at 2nd,19,56,Beale at Market,19,161,6
166,785.7831325301204,74,Steuart at Market,23,45,Commercial at Montgomery,15,138,28
166,1609.6506024096382,39,Powell Street BART,19,68,Yerba Buena Center of the Arts (3rd @ Howard),19,113,53
166,905.265060240964,47,Post at Kearny,19,56,Beale at Market,19,143,23
166,104964.3433734939,66,South Van Ness at Market,19,62,2nd at Folsom,19,147,19
166,1255.8915662650604,41,Clay at Battery,15,65,Townsend at 7th,15,150,16
165,475.4242424242424,63,Howard at 2nd,19,46,Washington at Kearny,15,146,19
165,602.8545454545458,63,Howard at 2nd,19,75,Mechanics Plaza (Market at Battery),19,153,12
165,716.624242424243,47,Post at Kearny,19,54,Embarcadero at Bryant,15,142,23
165,982.781818181818,58,San Francisco City Hall,19,47,Post at Kearny,19,148,17
165,909.9515151515152,71,Powell at Post (Union Square),19,54,Embarcadero at Bryant,15,118,47
163,1451.7055214723928,48,Embarcadero at Vallejo,15,41,Clay at Battery,15,105,58
163,4092.6809815950924,70,San Francisco Caltrain (Townsend at 4th),19,69,San Francisco Caltrain 2 (330 Townsend),23,121,42
162,1997.7654320987644,38,Park at Olive,15,35,University and Emerson,11,60,102
162,2526.5555555555566,58,San Francisco City Hall,19,74,Steuart at Market,23,67,95
161,1545.3602484472046,42,Davis at Jackson,15,67,Market at 10th,27,148,13
160,1387.0937500000005,7,Paseo de San Antonio,15,11,MLK Library,19,145,15
160,739.2562500000001,45,Commercial at Montgomery,15,62,2nd at Folsom,19,143,17
160,16066.51875,33,Rengstorff Avenue / California Street,15,33,Rengstorff Avenue / California Street,15,29,131
158,2049.9936708860746,54,Embarcadero at Bryant,15,73,Grant Avenue at Columbus Avenue,19,82,76
158,1339.107594936709,42,Davis at Jackson,15,72,Civic Center BART (7th at Market),23,150,8
158,371.0063291139238,6,San Pedro Square,15,14,Arena Green / SAP Center,19,129,29
158,1233.3797468354435,47,Post at Kearney,19,50,Harry Bridges Plaza (Ferry Building),23,105,53
157,513.6942675159235,46,Washington at Kearny,15,63,Howard at 2nd,19,130,27
157,1803.5668789808922,58,San Francisco City Hall,19,73,Grant Avenue at Columbus Avenue,19,114,43
156,1575.3717948717956,75,Mechanics Plaza (Market at Battery),19,65,Townsend at 7th,15,136,20
155,1159.5161290322592,49,Spear at Folsom,19,72,Civic Center BART (7th at Market),23,137,18
155,1053.8129032258068,10,San Jose City Hall,15,11,MLK Library,19,137,18
155,893.9935483870967,59,Golden Gate at Polk,23,75,Mechanics Plaza (Market at Battery),19,137,18
155,2405.8258064516126,47,Post at Kearny,19,71,Powell at Post (Union Square),19,89,66
154,609.1428571428571,64,2nd at South Park,15,47,Post at Kearney,19,127,27
154,416.40259740259756,16,SJSU - San Salvador at 9th,15,12,SJSU 4th at San Carlos,19,130,24
154,477.8896103896102,45,Commercial at Montgomery,15,41,Clay at Battery,15,138,16
154,1595.5000000000007,8,San Salvador at 1st,15,10,San Jose City Hall,15,135,19
153,824.8627450980395,10,San Jose City Hall,15,6,San Pedro Square,15,118,35
152,463.21052631578954,84,Ryland Park,15,9,Japantown,15,143,9
152,913.3618421052631,57,5th at Howard,15,46,Washington at Kearny,15,128,24
151,875.9470198675497,46,Washington at Kearny,15,54,Embarcadero at Bryant,15,125,26
151,2611.3311258278145,72,Civic Center BART (7th at Market),23,48,Embarcadero at Vallejo,15,95,56
151,636.2317880794701,48,Embarcadero at Vallejo,15,63,Howard at 2nd,19,120,31
151,374.19205298013264,13,St James Park,15,12,SJSU 4th at San Carlos,19,132,19
150,437.02000000000004,51,Embarcadero at Folsom,19,55,Temporary Transbay Terminal (Howard at Beale),23,139,11
150,818.9999999999998,47,Post at Kearney,19,73,Grant Avenue at Columbus Avenue,19,97,53
150,1191.2600000000002,46,Washington at Kearny,15,61,2nd at Townsend,27,97,53
150,1629.5266666666666,67,Market at 10th,27,58,San Francisco City Hall,19,116,34
149,321.63758389261744,22,Redwood City Caltrain Station,25,23,San Mateo County Center,15,139,10
149,890.0738255033559,75,Mechanics Plaza (Market at Battery),19,58,San Francisco City Hall,19,126,23
149,525.3624161073823,56,Beale at Market,19,62,2nd at Folsom,19,131,18
149,1207.3422818791944,51,Embarcadero at Folsom,19,39,Powell Street BART,19,104,45
148,1099.0405405405402,41,Clay at Battery,15,67,Market at 10th,27,113,35
148,762.5945945945945,6,San Pedro Square,15,80,Santa Clara County Civic Center,15,140,8
148,1095.7567567567564,38,Park at Olive,15,36,California Ave Caltrain Station,15,97,51
148,1690.8378378378375,60,Embarcadero at Sansome,15,62,2nd at Folsom,19,44,104
148,1590.506756756757,50,Harry Bridges Plaza (Ferry Building),23,47,Post at Kearney,19,116,32
148,1995.5540540540544,36,California Ave Caltrain Station,15,37,Cowper at University,11,80,68
148,2213.58108108108,46,Washington at Kearny,15,82,Broadway St at Battery St,15,103,45
147,1602.503401360544,6,San Pedro Square,15,10,San Jose City Hall,15,115,32
146,862.3767123287669,3,San Jose Civic Center,15,6,San Pedro Square,15,36,110
146,2075.4657534246585,67,Market at 10th,27,48,Embarcadero at Vallejo,15,90,56
146,2707.9041095890398,73,Grant Avenue at Columbus Avenue,19,48,Embarcadero at Vallejo,15,26,120
145,3652.7655172413793,12,SJSU 4th at San Carlos,19,16,SJSU - San Salvador at 9th,15,106,39
145,513.2758620689651,47,Post at Kearny,19,51,Embarcadero at Folsom,19,130,15
145,2380.303448275863,58,San Francisco City Hall,19,59,Golden Gate at Polk,23,102,43
145,436.696551724138,47,Post at Kearny,19,68,Yerba Buena Center of the Arts (3rd @ Howard),19,118,27
145,983.9793103448277,62,2nd at Folsom,19,82,Broadway St at Battery St,15,140,5
144,776.0416666666671,42,Davis at Jackson,15,46,Washington at Kearny,15,119,25
144,745.1041666666665,41,Clay at Battery,15,42,Davis at Jackson,15,127,17
144,572.0625000000001,47,Post at Kearny,19,49,Spear at Folsom,19,128,16
144,1936.9236111111106,33,Charleston Park/ North Bayshore Area,15,28,Mountain View Caltrain Station,23,66,78
144,1050.1458333333333,46,Washington at Kearny,15,72,Civic Center BART (7th at Market),23,97,47
143,658.1328671328671,58,San Francisco City Hall,19,57,5th at Howard,15,113,30
143,1330.5034965034956,46,Washington at Kearny,15,48,Embarcadero at Vallejo,15,52,91
143,3940.083916083916,29,San Antonio Caltrain Station,23,28,Mountain View Caltrain Station,23,54,89
142,907.2746478873238,71,Powell at Post (Union Square),19,51,Embarcadero at Folsom,19,101,41
142,5469.9084507042235,16,SJSU - San Salvador at 9th,15,16,SJSU - San Salvador at 9th,15,45,97
141,1417.0212765957442,8,San Salvador at 1st,15,16,SJSU - San Salvador at 9th,15,109,32
141,8013.929078014184,12,SJSU 4th at San Carlos,19,12,SJSU 4th at San Carlos,19,30,111
141,1106.7021276595744,57,5th at Howard,15,82,Broadway St at Battery St,15,125,16
141,630.0921985815605,3,San Jose Civic Center,15,4,Santa Clara at Almaden,11,82,59
139,1310.7122302158273,66,South Van Ness at Market,19,42,Davis at Jackson,15,121,18
139,436.431654676259,47,Post at Kearney,19,64,2nd at South Park,15,110,29
139,5979.3381294964,34,Palo Alto Caltrain Station,23,35,University and Emerson,11,46,93
139,1051.3884892086323,16,SJSU - San Salvador at 9th,15,11,MLK Library,19,105,34
137,948.8613138686131,56,Beale at Market,19,46,Washington at Kearny,15,111,26
137,1624.795620437956,64,2nd at South Park,15,59,Golden Gate at Polk,23,126,11
137,953.5839416058392,76,Market at 4th,19,47,Post at Kearny,19,106,31
136,740.8602941176472,82,Broadway St at Battery St,15,64,2nd at South Park,15,119,17
136,1435.4999999999998,68,Yerba Buena Center of the Arts (3rd @ Howard),19,75,Mechanics Plaza (Market at Battery),19,94,42
136,3218.691176470587,5,Adobe on Almaden,19,5,Adobe on Almaden,19,47,89
136,1555.6470588235295,66,South Van Ness at Market,19,48,Embarcadero at Vallejo,15,119,17
135,371.46666666666664,12,SJSU 4th at San Carlos,19,13,St James Park,15,109,26
135,881.577777777778,4,Santa Clara at Almaden,11,7,Paseo de San Antonio,15,119,16
135,5786.022222222224,66,South Van Ness at Market,19,41,Clay at Battery,15,108,27
135,2165.8074074074075,54,Embarcadero at Bryant,15,71,Powell at Post (Union Square),19,64,71
134,840.5746268656712,55,Temporary Transbay Terminal (Howard at Beale),23,46,Washington at Kearney,15,117,17
134,720.9402985074626,10,San Jose City Hall,15,3,San Jose Civic Center,15,106,28
134,1047.1119402985069,49,Spear at Folsom,19,59,Golden Gate at Polk,23,133,1
134,2317.4477611940288,73,Grant Avenue at Columbus Avenue,19,58,San Francisco City Hall,19,100,34
133,1485.6015037593984,58,San Francisco City Hall,19,61,2nd at Townsend,27,105,28
133,1074.360902255639,39,Powell Street BART,19,42,Davis at Jackson,15,109,24
133,3953.5037593984953,9,Japantown,15,7,Paseo de San Antonio,15,81,52
133,1336.8571428571424,46,Washington at Kearny,15,74,Steuart at Market,23,69,64
132,881.1515151515149,64,2nd at South Park,15,82,Broadway St at Battery St,15,118,14
132,555.9696969696968,68,Yerba Buena Center of the Arts (3rd @ Howard),19,62,2nd at Folsom,19,109,23
131,1366.572519083969,47,Post at Kearny,19,59,Golden Gate at Polk,23,107,24
131,790.8167938931299,65,Townsend at 7th,15,58,San Francisco City Hall,19,109,22
131,1676.480916030534,68,Yerba Buena Center of the Arts (3rd @ Howard),19,59,Golden Gate at Polk,23,96,35
130,1117.2769230769225,62,2nd at Folsom,19,66,South Van Ness at Market,19,100,30
130,1677.9076923076918,48,Embarcadero at Vallejo,15,57,5th at Howard,15,77,53
130,2221.453846153847,48,Embarcadero at Vallejo,15,72,Civic Center BART (7th at Market),23,73,57
130,582.7153846153847,46,Washington at Kearny,15,42,Davis at Jackson,15,109,21
129,531.3875968992248,51,Embarcadero at Folsom,19,41,Clay at Battery,15,110,19
129,1031.4883720930231,63,Howard at 2nd,19,59,Golden Gate at Polk,23,111,18
129,876.4961240310075,58,San Francisco City Hall,19,64,2nd at South Park,15,116,13
129,1054.3488372093022,82,Broadway St at Battery St,15,67,Market at 10th,27,119,10
129,1104.7054263565894,62,2nd at Folsom,19,48,Embarcadero at Vallejo,15,80,49
128,974.6093750000007,59,Golden Gate at Polk,23,64,2nd at South Park,15,118,10
128,1617.5312500000002,82,Broadway St at Battery St,15,73,Grant Avenue at Columbus Avenue,19,61,67
128,830.5156249999999,56,Beale at Market,19,41,Clay at Battery,15,114,14
128,1836.1250000000007,66,South Van Ness at Market,19,46,Washington at Kearny,15,93,35
127,1346.3543307086613,54,Embarcadero at Bryant,15,39,Powell Street BART,19,85,42
127,994.8425196850392,6,San Pedro Square,15,11,MLK Library,19,73,54
127,540.8661417322835,7,Paseo de San Antonio,15,13,St James Park,15,92,35
127,632.6614173228351,22,Redwood City Caltrain Station,25,24,Redwood City Public Library,15,122,5
126,1607.3412698412699,58,San Francisco City Hall,19,45,Commercial at Montgomery,15,107,19
126,1009.1190476190478,47,Post at Kearny,19,62,2nd at Folsom,19,108,18
126,4919.9126984127,33,Rengstorff Avenue / California Street,15,27,Mountain View City Hall,15,68,58
125,2188.183999999998,69,San Francisco Caltrain 2 (330 Townsend),23,73,Grant Avenue at Columbus Avenue,19,89,36
125,523.8080000000001,13,St James Park,15,11,MLK Library,19,107,18
125,1810.6560000000004,51,Embarcadero at Folsom,19,72,Civic Center BART (7th at Market),23,106,19
124,404.24193548387103,36,California Ave Caltrain Station,15,38,Park at Olive,15,95,29
124,852.5161290322577,6,San Pedro Square,15,8,San Salvador at 1st,15,84,40
124,873.1048387096773,72,Civic Center BART (7th at Market),23,51,Embarcadero at Folsom,19,112,12
124,1976.4838709677413,9,Japantown,15,8,San Salvador at 1st,15,80,44
123,489.7154471544715,26,Kaiser Hospital,15,22,Redwood City Caltrain Station,25,122,1
123,2832.9756097560985,32,Castro Street and El Camino Real,11,27,Mountain View City Hall,15,81,42
123,1120.6666666666663,35,University and Emerson,11,38,Park at Olive,15,59,64
123,976.5203252032518,67,Market at 10th,27,41,Clay at Battery,15,97,26
123,768.5040650406505,54,Embarcadero at Bryant,15,57,5th at Howard,15,106,17
123,730.7235772357724,70,San Francisco Caltrain (Townsend at 4th),19,47,Post at Kearney,19,107,16
123,652.9674796747969,51,Embarcadero at Folsom,19,47,Post at Kearny,19,105,18
122,1168.8032786885246,42,Davis at Jackson,15,41,Clay at Battery,15,103,19
122,688.8360655737699,47,Post at Kearney,19,70,San Francisco Caltrain (Townsend at 4th),19,105,17
121,1860.2644628099174,68,Yerba Buena Center of the Arts (3rd @ Howard),19,48,Embarcadero at Vallejo,15,34,87
121,723.3553719008265,14,Arena Green / SAP Center,19,13,St James Park,15,104,17
120,1562.9083333333335,28,Mountain View Caltrain Station,23,33,Charleston Park/ North Bayshore Area,15,44,76
120,626.6416666666665,13,St James Park,15,8,San Salvador at 1st,15,110,10
120,1183.3416666666674,59,Golden Gate at Polk,23,61,2nd at Townsend,27,98,22
120,1454.9249999999997,65,Townsend at 7th,15,73,Grant Avenue at Columbus Avenue,19,100,20
120,2063.283333333333,66,South Van Ness at Market,19,73,Grant Avenue at Columbus Avenue,19,72,48
119,854.5798319327731,47,Post at Kearney,19,66,South Van Ness at Market,19,109,10
119,898.4789915966387,3,San Jose Civic Center,15,11,MLK Library,19,71,48
119,882.4453781512603,63,Howard at 2nd,19,62,2nd at Folsom,19,104,15
119,1156.831932773109,11,MLK Library,19,6,San Pedro Square,15,63,56
119,3238.3529411764707,39,Powell Street BART,19,54,Embarcadero at Bryant,15,78,41
118,1463.4661016949146,56,Beale at Market,19,75,Mechanics Plaza (Market at Battery),19,97,21
118,332.0084745762712,21,Franklin at Maple,15,22,Redwood City Caltrain Station,25,99,19
118,2160.3983050847464,59,Golden Gate at Polk,23,58,San Francisco City Hall,19,73,45
117,1476.5555555555552,48,Embarcadero at Vallejo,15,68,Yerba Buena Center of the Arts (3rd @ Howard),19,52,65
117,1086.3675213675215,39,Powell Street BART,19,82,Broadway St at Battery St,15,99,18
117,4560.74358974359,23,San Mateo County Center,15,23,San Mateo County Center,15,85,32
117,664.905982905983,66,South Van Ness at Market,19,47,Post at Kearney,19,111,6
116,1440.3965517241381,54,Embarcadero at Bryant,15,72,Civic Center BART (7th at Market),23,98,18
116,2723.879310344828,33,Charleston Park/ North Bayshore Area,15,33,Charleston Park/ North Bayshore Area,15,2,114
116,1529.7672413793105,51,Embarcadero at Folsom,19,66,South Van Ness at Market,19,85,31
115,1645.6173913043472,51,Embarcadero at Folsom,19,71,Powell at Post (Union Square),19,72,43
115,926.0347826086959,72,Civic Center BART (7th at Market),23,49,Spear at Folsom,19,99,16
115,3008.617391304348,41,Clay at Battery,15,59,Golden Gate at Polk,23,83,32
115,1249.330434782609,48,Embarcadero at Vallejo,15,46,Washington at Kearny,15,61,54
114,1122.0350877192977,47,Post at Kearney,19,60,Embarcadero at Sansome,15,52,62
114,858.517543859649,72,Civic Center BART (7th at Market),23,42,Davis at Jackson,15,104,10
114,732.2105263157891,9,Japantown,15,13,St James Park,15,92,22
114,828.3333333333334,61,2nd at Townsend,27,47,Post at Kearney,19,99,15
113,817.7079646017698,4,Santa Clara at Almaden,11,3,San Jose Civic Center,15,59,54
113,1155.7876106194692,66,South Van Ness at Market,19,82,Broadway St at Battery St,15,102,11
113,3787.7876106194694,68,Yerba Buena Center of the Arts (3rd @ Howard),19,63,Howard at 2nd,19,75,38
112,1084.6428571428573,65,Townsend at 7th,15,41,Clay at Battery,15,101,11
112,985.3214285714288,59,Golden Gate at Polk,23,82,Broadway St at Battery St,15,105,7
111,18192.081081081084,38,Park at Olive,15,38,Park at Olive,15,13,98
111,631.918918918919,63,Howard at 2nd,19,42,Davis at Jackson,15,106,5
110,2358.809090909092,27,Mountain View City Hall,15,33,Rengstorff Avenue / California Street,15,64,46
110,714.3181818181819,57,5th at Howard,15,58,San Francisco City Hall,19,82,28
110,489.9545454545453,10,San Jose City Hall,15,12,SJSU 4th at San Carlos,19,97,13
110,659.8727272727274,51,Embarcadero at Folsom,19,62,2nd at Folsom,19,88,22
109,1852.1834862385308,16,SJSU - San Salvador at 9th,15,10,San Jose City Hall,15,81,28
108,2362.203703703705,46,Washington at Kearney,15,60,Embarcadero at Sansome,15,15,93
107,1094.3925233644861,6,San Pedro Square,15,16,SJSU - San Salvador at 9th,15,57,50
107,459.8598130841123,11,MLK Library,19,8,San Salvador at 1st,15,95,12
107,1108.7757009345796,54,Embarcadero at Bryant,15,46,Washington at Kearny,15,95,12
107,944.1028037383178,11,MLK Library,19,7,Paseo de San Antonio,15,86,21
106,488.15094339622635,7,Paseo de San Antonio,15,4,Santa Clara at Almaden,11,90,16
106,1417.4811320754716,46,Washington at Kearny,15,65,Townsend at 7th,15,75,31
106,1239.8679245283015,65,Townsend at 7th,15,46,Washington at Kearny,15,96,10
106,553.2075471698113,73,Grant Avenue at Columbus Avenue,19,47,Post at Kearney,19,83,23
105,1301.952380952381,72,Civic Center BART (7th at Market),23,82,Broadway St at Battery St,15,99,6
104,441.6730769230769,13,St James Park,15,14,Arena Green / SAP Center,19,99,5
104,1009.355769230769,63,Howard at 2nd,19,58,San Francisco City Hall,19,86,18
104,1219.7788461538464,65,Townsend at 7th,15,75,Mechanics Plaza (Market at Battery),19,95,9
103,617.3009708737858,3,San Jose Civic Center,15,10,San Jose City Hall,15,83,20
103,4713.417475728156,73,Grant Avenue at Columbus Avenue,19,59,Golden Gate at Polk,23,52,51
103,598.73786407767,13,St James Park,15,7,Paseo de San Antonio,15,85,18
103,965.1747572815534,84,Ryland Park,15,5,Adobe on Almaden,19,97,6
103,2251.4854368932038,49,Spear at Folsom,19,46,Washington at Kearny,15,90,13
102,2548.0196078431363,54,Embarcadero at Bryant,15,47,Post at Kearny,19,76,26
102,11316.16666666667,31,San Antonio Shopping Center,15,31,San Antonio Shopping Center,15,36,66
102,2937.813725490196,48,Embarcadero at Vallejo,15,66,South Van Ness at Market,19,72,30
102,730.2745098039219,30,Evelyn Park and Ride,15,27,Mountain View City Hall,15,76,26
102,1229.245098039216,64,2nd at South Park,15,58,San Francisco City Hall,19,81,21
102,1237.13725490196,82,Broadway St at Battery St,15,66,South Van Ness at Market,19,93,9
101,713.138613861386,41,Clay at Battery,15,45,Commercial at Montgomery,15,82,19
101,4863.306930693071,13,St James Park,15,13,St James Park,15,44,57
101,827.3465346534656,67,Market at 10th,27,47,Post at Kearney,19,92,9
100,1241.15,60,Embarcadero at Sansome,15,46,Washington at Kearney,15,21,79
100,1618.4400000000005,5,Adobe on Almaden,19,7,Paseo de San Antonio,15,84,16
100,918.8799999999999,58,San Francisco City Hall,19,56,Beale at Market,19,83,17
99,961.9595959595957,60,Embarcadero at Sansome,15,47,Post at Kearney,19,61,38
99,963.6868686868686,72,Civic Center BART (7th at Market),23,54,Embarcadero at Bryant,15,82,17
99,739.7373737373737,47,Post at Kearny,19,58,San Francisco City Hall,19,78,21
99,1899.7474747474755,46,Washington at Kearny,15,66,South Van Ness at Market,19,43,56
99,307.67676767676767,83,Mezes,15,22,Redwood City Caltrain Station,25,94,5
99,1494.6161616161614,47,Post at Kearney,19,67,Market at 10th,27,83,16
99,2384.464646464646,47,Post at Kearny,19,48,Embarcadero at Vallejo,15,42,57
99,1462.2020202020199,8,San Salvador at 1st,15,12,SJSU 4th at San Carlos,19,83,16
99,2969.595959595959,11,MLK Library,19,10,San Jose City Hall,15,78,21
98,1269.1428571428576,42,Davis at Jackson,15,65,Townsend at 7th,15,76,22
98,827.204081632653,48,Embarcadero at Vallejo,15,45,Commercial at Montgomery,15,53,45
98,1036.6734693877547,41,Clay at Battery,15,66,South Van Ness at Market,19,74,24
98,3705.8775510204077,80,Santa Clara County Civic Center,15,80,Santa Clara County Civic Center,15,47,51
98,4279.642857142856,10,San Jose City Hall,15,16,SJSU - San Salvador at 9th,15,71,27
98,670.1530612244899,46,Washington at Kearny,15,41,Clay at Battery,15,76,22
97,1222.1030927835052,58,San Francisco City Hall,19,68,Yerba Buena Center of the Arts (3rd @ Howard),19,61,36
97,839.4639175257731,46,Washington at Kearny,15,68,Yerba Buena Center of the Arts (3rd @ Howard),19,41,56
97,615.1134020618556,82,Broadway St at Battery St,15,63,Howard at 2nd,19,83,14
97,753.2783505154641,59,Golden Gate at Polk,23,63,Howard at 2nd,19,87,10
97,561.2989690721648,46,Washington at Kearney,15,55,Temporary Transbay Terminal (Howard at Beale),23,88,9
97,1215.4329896907216,65,Townsend at 7th,15,82,Broadway St at Battery St,15,84,13
97,1051.0309278350514,27,Mountain View City Hall,15,31,San Antonio Shopping Center,15,44,53
96,1245.1041666666672,8,San Salvador at 1st,15,9,Japantown,15,76,20
96,869.1875000000003,5,Adobe on Almaden,19,6,San Pedro Square,15,64,32
95,1416.8105263157897,68,Yerba Buena Center of the Arts (3rd @ Howard),19,58,San Francisco City Hall,19,64,31
95,952.252631578947,46,Washington at Kearney,15,50,Harry Bridges Plaza (Ferry Building),23,61,34
95,610.3684210526316,46,Washington at Kearney,15,51,Embarcadero at Folsom,19,87,8
95,2549.484210526316,27,Mountain View City Hall,15,32,Castro Street and El Camino Real,11,68,27
95,750.1157894736845,49,Spear at Folsom,19,47,Post at Kearny,19,84,11
95,1503.621052631579,39,Powell Street BART,19,51,Embarcadero at Folsom,19,62,33
95,898.221052631579,41,Clay at Battery,15,46,Washington at Kearny,15,68,27
94,2601.202127659574,82,Broadway St at Battery St,15,48,Embarcadero at Vallejo,15,49,45
94,527.7553191489363,51,Embarcadero at Folsom,19,46,Washington at Kearney,15,92,2
94,319.5744680851065,22,Redwood City Caltrain Station,25,83,Mezes,15,92,2
94,549.9893617021274,10,San Jose City Hall,15,5,Adobe on Almaden,19,79,15
94,2196.4680851063827,11,MLK Library,19,3,San Jose Civic Center,15,43,51
94,526.8723404255321,62,2nd at Folsom,19,47,Post at Kearney,19,82,12
94,751.4680851063831,14,Arena Green / SAP Center,19,7,Paseo de San Antonio,15,74,20
93,1100.1290322580644,12,SJSU 4th at San Carlos,19,11,MLK Library,19,70,23
93,3250.129032258065,42,Davis at Jackson,15,66,South Van Ness at Market,19,72,21
93,824.8387096774193,59,Golden Gate at Polk,23,41,Clay at Battery,15,75,18
93,498.6774193548387,47,Post at Kearney,19,49,Spear at Folsom,19,84,9
92,3584.9782608695664,49,Spear at Folsom,19,51,Embarcadero at Folsom,19,69,23
92,535.3260869565217,45,Commercial at Montgomery,15,47,Post at Kearney,19,84,8
92,727.9239130434784,67,Market at 10th,27,46,Washington at Kearney,15,74,18
92,545.0652173913044,11,MLK Library,19,13,St James Park,15,74,18
92,1586.3260869565222,31,San Antonio Shopping Center,15,35,University and Emerson,11,89,3
91,816.7142857142859,58,San Francisco City Hall,19,55,Temporary Transbay Terminal (Howard at Beale),23,86,5
91,4776.582417582418,48,Embarcadero at Vallejo,15,67,Market at 10th,27,47,44
91,1357.2417582417586,75,Mechanics Plaza (Market at Battery),19,62,2nd at Folsom,19,78,13
90,767.5666666666666,16,SJSU - San Salvador at 9th,15,6,San Pedro Square,15,51,39
90,1098.977777777778,55,Temporary Transbay Terminal (Howard at Beale),23,58,San Francisco City Hall,19,80,10
89,896.0,82,Broadway St at Battery St,15,68,Yerba Buena Center of the Arts (3rd @ Howard),19,71,18
89,559.3258426966294,47,Post at Kearney,19,61,2nd at Townsend,27,77,12
89,8091.3820224719075,46,Washington at Kearney,15,46,Washington at Kearney,15,6,83
89,675.8426966292137,8,San Salvador at 1st,15,13,St James Park,15,73,16
88,8002.9659090909145,35,University and Emerson,11,34,Palo Alto Caltrain Station,23,30,58
88,3083.1818181818194,74,Steuart at Market,23,58,San Francisco City Hall,19,58,30
87,2246.8505747126437,36,California Ave Caltrain Station,15,29,San Antonio Caltrain Station,23,57,30
87,1729.160919540229,61,2nd at Townsend,27,58,San Francisco City Hall,19,61,26
87,452.5287356321839,12,SJSU 4th at San Carlos,19,8,San Salvador at 1st,15,72,15
86,1345.6046511627903,7,Paseo de San Antonio,15,3,San Jose Civic Center,15,24,62
86,617.7209302325582,7,Paseo de San Antonio,15,84,Ryland Park,15,69,17
86,493.6279069767442,13,St James Park,15,10,San Jose City Hall,15,76,10
86,652.1744186046516,63,Howard at 2nd,19,82,Broadway St at Battery St,15,76,10
86,1780.3604651162789,67,Market at 10th,27,54,Embarcadero at Bryant,15,63,23
86,837.5930232558137,58,San Francisco City Hall,19,62,2nd at Folsom,19,72,14
85,3618.5882352941176,7,Paseo de San Antonio,15,10,San Jose City Hall,15,62,23
85,977.6588235294116,57,5th at Howard,15,54,Embarcadero at Bryant,15,59,26
85,1110.0,48,Embarcadero at Vallejo,15,82,Broadway St at Battery St,15,55,30
85,528.9294117647057,22,Redwood City Caltrain Station,25,26,Kaiser Hospital,15,83,2
84,4272.416666666666,60,Embarcadero at Sansome,15,58,San Francisco City Hall,19,30,54
84,2057.1428571428573,3,San Jose Civic Center,15,5,Adobe on Almaden,19,58,26
84,1487.2619047619048,51,Embarcadero at Folsom,19,49,Spear at Folsom,19,64,20
84,1509.5952380952376,25,Stanford in Redwood City,15,34,Palo Alto Caltrain Station,23,84,0
84,729.0119047619049,47,Post at Kearney,19,69,San Francisco Caltrain 2 (330 Townsend),23,81,3
84,1109.8928571428569,76,Market at 4th,19,46,Washington at Kearney,15,65,19
84,1998.6666666666658,23,San Mateo County Center,15,22,Redwood City Caltrain Station,25,74,10
84,4908.535714285715,61,2nd at Townsend,27,59,Golden Gate at Polk,23,54,30
83,625.2530120481928,12,SJSU 4th at San Carlos,19,6,San Pedro Square,15,61,22
83,1251.3012048192772,82,Broadway St at Battery St,15,65,Townsend at 7th,15,68,15
83,1754.4337349397586,5,Adobe on Almaden,19,8,San Salvador at 1st,15,72,11
83,2270.6867469879517,48,Embarcadero at Vallejo,15,47,Post at Kearny,19,42,41
83,1347.1686746987953,42,Davis at Jackson,15,62,2nd at Folsom,19,68,15
82,2118.7317073170734,67,Market at 10th,27,51,Embarcadero at Folsom,19,68,14
82,1025.963414634147,57,5th at Howard,15,42,Davis at Jackson,15,79,3
82,610.6341463414634,46,Washington at Kearny,15,49,Spear at Folsom,19,75,7
82,1030.0365853658536,58,San Francisco City Hall,19,49,Spear at Folsom,19,69,13
81,1095.1975308641975,11,MLK Library,19,12,SJSU 4th at San Carlos,19,54,27
81,888.9135802469136,65,Townsend at 7th,15,47,Post at Kearney,19,73,8
81,1221.901234567901,14,Arena Green / SAP Center,19,80,Santa Clara County Civic Center,15,67,14
81,344.0987654320989,47,Post at Kearney,19,62,2nd at Folsom,19,74,7
81,1372.7283950617293,46,Washington at Kearny,15,59,Golden Gate at Polk,23,59,22
81,1802.1728395061725,24,Redwood City Public Library,15,22,Redwood City Caltrain Station,25,67,14
81,1007.3703703703701,42,Davis at Jackson,15,57,5th at Howard,15,66,15
80,1804.05,50,Harry Bridges Plaza (Ferry Building),23,46,Washington at Kearney,15,33,47
80,1723.5125000000005,75,Mechanics Plaza (Market at Battery),19,56,Beale at Market,19,58,22
80,524.4875000000001,12,SJSU 4th at San Carlos,19,7,Paseo de San Antonio,15,58,22
80,1828.4124999999997,51,Embarcadero at Folsom,19,67,Market at 10th,27,50,30
80,2328.825,9,Japantown,15,3,San Jose Civic Center,15,12,68
79,1950.126582278481,3,San Jose Civic Center,15,7,Paseo de San Antonio,15,30,49
79,1383.6708860759493,45,Commercial at Montgomery,15,48,Embarcadero at Vallejo,15,47,32
79,653.3670886075947,84,Ryland Park,15,7,Paseo de San Antonio,15,67,12
79,645.2025316455698,47,Post at Kearney,19,74,Steuart at Market,23,43,36
78,1156.4487179487176,68,Yerba Buena Center of the Arts (3rd @ Howard),19,82,Broadway St at Battery St,15,58,20
78,987.6794871794874,58,San Francisco City Hall,19,46,Washington at Kearny,15,61,17
78,7931.487179487179,32,Castro Street and El Camino Real,11,31,San Antonio Shopping Center,15,49,29
78,1077.8205128205127,59,Golden Gate at Polk,23,45,Commercial at Montgomery,15,71,7
78,993.6923076923077,5,Adobe on Almaden,19,3,San Jose Civic Center,15,49,29
77,2130.415584415585,47,Post at Kearny,19,77,Market at Sansome,27,51,26
77,815.0519480519483,9,Japantown,15,4,Santa Clara at Almaden,11,63,14
77,1369.7012987012986,31,San Antonio Shopping Center,15,27,Mountain View City Hall,15,39,38
76,977.6578947368423,58,San Francisco City Hall,19,63,Howard at 2nd,19,65,11
76,823.6973684210526,7,Paseo de San Antonio,15,5,Adobe on Almaden,19,63,13
76,7019.3421052631575,54,Embarcadero at Bryant,15,67,Market at 10th,27,47,29
76,9594.499999999998,35,University and Emerson,11,31,San Antonio Shopping Center,15,67,9
76,823.0263157894736,46,Washington at Kearney,15,67,Market at 10th,27,68,8
75,677.2800000000001,31,San Antonio Shopping Center,15,33,Rengstorff Avenue / California Street,15,64,11
75,1623.0533333333333,67,Market at 10th,27,82,Broadway St at Battery St,15,60,15
75,1633.0933333333326,14,Arena Green / SAP Center,19,3,San Jose Civic Center,15,13,62
74,1203.8513513513512,80,Santa Clara County Civic Center,15,14,Arena Green / SAP Center,19,65,9
74,2113.135135135136,12,SJSU 4th at San Carlos,19,3,San Jose Civic Center,15,35,39
74,1631.5810810810806,64,2nd at South Park,15,46,Washington at Kearney,15,67,7
74,885.2027027027025,58,San Francisco City Hall,19,47,Post at Kearney,19,55,19
73,726.0958904109589,59,Golden Gate at Polk,23,47,Post at Kearney,19,65,8
73,784.5342465753426,62,2nd at Folsom,19,58,San Francisco City Hall,19,69,4
73,1134.191780821917,37,Cowper at University,11,38,Park at Olive,15,35,38
72,1532.3611111111115,38,Park at Olive,15,37,Cowper at University,11,27,45
72,2514.125,56,Beale at Market,19,58,San Francisco City Hall,19,54,18
72,2114.0972222222226,29,San Antonio Caltrain Station,23,27,Mountain View City Hall,15,51,21
72,632.5972222222225,5,Adobe on Almaden,19,12,SJSU 4th at San Carlos,19,62,10
71,5376.042253521126,5,Adobe on Almaden,19,11,MLK Library,19,53,18
71,472.66197183098603,75,Mechanics Plaza (Market at Battery),19,46,Washington at Kearney,15,59,12
71,534.6760563380283,6,San Pedro Square,15,5,Adobe on Almaden,19,48,23
71,1764.4929577464789,82,Broadway St at Battery St,15,59,Golden Gate at Polk,23,59,12
71,1240.549295774648,46,Washington at Kearney,15,39,Powell Street BART,19,49,22
71,840.6901408450701,47,Post at Kearney,19,39,Powell Street BART,19,61,10
70,2239.214285714286,29,San Antonio Caltrain Station,23,36,California Ave Caltrain Station,15,29,41
70,613.8428571428569,5,Adobe on Almaden,19,10,San Jose City Hall,15,51,19
70,493.9428571428571,55,Temporary Transbay Terminal (Howard at Beale),23,47,Post at Kearney,19,66,4
69,1767.8550724637678,27,Mountain View City Hall,15,29,San Antonio Caltrain Station,23,52,17
69,1005.072463768116,3,San Jose Civic Center,15,14,Arena Green / SAP Center,19,24,45
69,5724.492753623188,6,San Pedro Square,15,4,Santa Clara at Almaden,11,42,27
69,1124.434782608696,5,Adobe on Almaden,19,84,Ryland Park,15,61,8
69,11229.710144927536,3,San Jose Civic Center,15,12,SJSU 4th at San Carlos,19,25,44
68,4658.558823529413,8,San Salvador at 1st,15,3,San Jose Civic Center,15,35,33
68,387.77941176470597,47,Post at Kearney,19,55,Temporary Transbay Terminal (Howard at Beale),23,64,4
68,682.3970588235293,14,Arena Green / SAP Center,19,84,Ryland Park,15,54,14
68,763.7647058823527,49,Spear at Folsom,19,47,Post at Kearney,19,50,18
67,1345.4477611940297,59,Golden Gate at Polk,23,46,Washington at Kearny,15,54,13
67,1132.4328358208954,33,Rengstorff Avenue / California Street,15,31,San Antonio Shopping Center,15,58,9
67,9732.074626865671,24,Redwood City Public Library,15,24,Redwood City Public Library,15,20,47
67,515.9999999999999,46,Washington at Kearney,15,77,Market at Sansome,27,54,13
66,955.8484848484848,47,Post at Kearney,19,63,Howard at 2nd,19,61,5
66,832.636363636364,28,Mountain View Caltrain Station,23,30,Middlefield Light Rail Station,15,62,4
66,570.7121212121212,27,Mountain View City Hall,15,30,Evelyn Park and Ride,15,47,19
65,654.5076923076921,6,San Pedro Square,15,12,SJSU 4th at San Carlos,19,44,21
65,1502.1538461538462,34,Palo Alto Caltrain Station,23,25,Stanford in Redwood City,15,64,1
64,805.0468750000001,82,Broadway St at Battery St,15,62,2nd at Folsom,19,60,4
64,716.3906249999999,10,San Jose City Hall,15,13,St James Park,15,62,2
64,1838.5,82,Broadway St at Battery St,15,46,Washington at Kearny,15,41,23
63,4369.301587301587,3,San Jose Civic Center,15,16,SJSU - San Salvador at 9th,15,28,35
63,1562.0,4,Santa Clara at Almaden,11,6,San Pedro Square,15,46,17
63,1256.3333333333333,66,South Van Ness at Market,19,54,Embarcadero at Bryant,15,53,10
63,2488.0158730158737,25,Stanford in Redwood City,15,25,Stanford in Redwood City,15,36,27
63,2788.2380952380954,7,Paseo de San Antonio,15,12,SJSU 4th at San Carlos,19,45,18
62,3462.4032258064526,74,Steuart at Market,23,56,Beale at Market,19,43,19
62,995.4354838709679,42,Davis at Jackson,15,59,Golden Gate at Polk,23,59,3
62,923.3225806451615,47,Post at Kearney,19,45,Commercial at Montgomery,15,57,5
62,1548.0806451612905,4,Santa Clara at Almaden,11,8,San Salvador at 1st,15,47,15
61,730.1147540983607,69,San Francisco Caltrain 2 (330 Townsend),23,47,Post at Kearney,19,56,5
61,3497.3770491803275,48,Embarcadero at Vallejo,15,62,2nd at Folsom,19,29,32
61,1113.7540983606552,80,Santa Clara County Civic Center,15,9,Japantown,15,36,25
61,2767.344262295081,2,San Jose Diridon Caltrain Station,27,14,Arena Green / SAP Center,19,44,17
61,1101.6885245901642,7,Paseo de San Antonio,15,14,Arena Green / SAP Center,19,38,23
60,802.8833333333334,23,San Mateo County Center,15,24,Redwood City Public Library,15,57,3
60,345.4666666666667,63,Howard at 2nd,19,47,Post at Kearney,19,56,4
60,2119.35,46,Washington at Kearny,15,58,San Francisco City Hall,19,32,28
60,741.3666666666666,3,San Jose Civic Center,15,84,Ryland Park,15,36,24
59,3104.5593220338988,47,Post at Kearney,19,47,Post at Kearney,19,24,35
59,711.084745762712,13,St James Park,15,5,Adobe on Almaden,19,46,13
59,604.5932203389834,16,SJSU - San Salvador at 9th,15,13,St James Park,15,46,13
59,2302.64406779661,14,Arena Green / SAP Center,19,9,Japantown,15,37,22
58,439.551724137931,47,Post at Kearney,19,57,5th at Howard,15,53,5
58,416.65517241379297,46,Washington at Kearney,15,56,Beale at Market,19,53,5
58,926.1551724137931,16,SJSU - San Salvador at 9th,15,3,San Jose Civic Center,15,27,31
58,876.1724137931035,47,Post at Kearney,19,59,Golden Gate at Polk,23,50,8
57,983.9824561403507,45,Commercial at Montgomery,15,59,Golden Gate at Polk,23,49,8
56,474.5178571428571,39,Powell Street BART,19,47,Post at Kearney,19,46,10
56,771.6785714285712,11,MLK Library,19,4,Santa Clara at Almaden,11,37,19
56,34568.7857142857,31,San Antonio Shopping Center,15,32,Castro Street and El Camino Real,11,35,21
56,3523.660714285715,48,Embarcadero at Vallejo,15,59,Golden Gate at Polk,23,29,27
55,1885.163636363636,71,Powell at Post (Union Square),19,47,Post at Kearney,19,40,15
55,1683.3999999999999,71,Powell at Post (Union Square),19,46,Washington at Kearney,15,29,26
55,650.036363636364,46,Washington at Kearny,15,62,2nd at Folsom,19,48,7
55,1519.709090909091,62,2nd at Folsom,19,59,Golden Gate at Polk,23,44,11
55,2563.2545454545457,14,Arena Green / SAP Center,19,8,San Salvador at 1st,15,32,23
55,974.4000000000001,47,Post at Kearney,19,65,Townsend at 7th,15,46,9
55,3494.3454545454547,38,Park at Olive,15,29,San Antonio Caltrain Station,23,26,29
55,679.6363636363635,4,Santa Clara at Almaden,11,11,MLK Library,19,34,21
54,1426.185185185185,41,Clay at Battery,15,58,San Francisco City Hall,19,42,12
54,3319.24074074074,59,Golden Gate at Polk,23,73,Grant Avenue at Columbus Avenue,19,27,27
54,1348.4074074074074,47,Post at Kearney,19,58,San Francisco City Hall,19,40,14
53,880.4716981132076,10,San Jose City Hall,15,14,Arena Green / SAP Center,19,40,13
52,1706.3269230769235,3,San Jose Civic Center,15,9,Japantown,15,14,38
52,2612.576923076924,12,SJSU 4th at San Carlos,19,9,Japantown,15,34,18
52,1083.903846153846,12,SJSU 4th at San Carlos,19,10,San Jose City Hall,15,32,20
51,1935.9215686274513,47,Post at Kearney,19,71,Powell at Post (Union Square),19,26,25
51,763.3529411764705,8,San Salvador at 1st,15,5,Adobe on Almaden,19,41,10
51,1363.4117647058822,29,San Antonio Caltrain Station,23,38,Park at Olive,15,15,36
51,1113.8039215686279,46,Washington at Kearney,15,69,San Francisco Caltrain 2 (330 Townsend),23,48,3
51,1108.6862745098042,77,Market at Sansome,27,46,Washington at Kearney,15,41,10
50,1273.0799999999997,9,Japantown,15,16,SJSU - San Salvador at 9th,15,23,27
50,712.1,49,Spear at Folsom,19,46,Washington at Kearney,15,48,2
50,1574.8200000000004,39,Powell Street BART,19,46,Washington at Kearney,15,37,13
50,463.2600000000001,57,5th at Howard,15,47,Post at Kearney,19,44,6
50,2569.9400000000005,47,Post at Kearney,19,72,Civic Center BART (7th at Market),23,38,12
50,1043.5199999999998,74,Steuart at Market,23,47,Post at Kearney,19,38,12
49,3253.0204081632646,77,Market at Sansome,27,47,Post at Kearny,19,22,27
49,546.9387755102041,24,Redwood City Public Library,15,23,San Mateo County Center,15,46,3
49,11078.204081632653,3,San Jose Civic Center,15,8,San Salvador at 1st,15,17,32
49,1063.3265306122448,84,Ryland Park,15,12,SJSU 4th at San Carlos,19,38,11
49,907.5714285714288,9,Japantown,15,12,SJSU 4th at San Carlos,19,36,13
48,904.9375000000002,46,Washington at Kearney,15,74,Steuart at Market,23,33,15
48,1441.8333333333335,26,Redwood City Medical Center,15,23,San Mateo County Center,15,46,2
48,3941.479166666667,14,Arena Green / SAP Center,19,2,San Jose Diridon Caltrain Station,27,33,15
48,3128.500000000001,54,Embarcadero at Bryant,15,66,South Van Ness at Market,19,20,28
48,1017.5833333333331,72,Civic Center BART (7th at Market),23,47,Post at Kearney,19,42,6
47,896.8297872340424,8,San Salvador at 1st,15,14,Arena Green / SAP Center,19,37,10
47,834.255319148936,84,Ryland Park,15,14,Arena Green / SAP Center,19,29,18
47,774.4255319148934,42,Davis at Jackson,15,68,Yerba Buena Center of the Arts (3rd @ Howard),19,40,7
47,1272.9361702127655,16,SJSU - San Salvador at 9th,15,5,Adobe on Almaden,19,41,6
47,2195.021276595746,58,San Francisco City Hall,19,42,Davis at Jackson,15,44,3
47,2135.63829787234,84,Ryland Park,15,11,MLK Library,19,28,19
46,1071.3478260869565,68,Yerba Buena Center of the Arts (3rd @ Howard),19,42,Davis at Jackson,15,39,7
46,865.4347826086956,4,Santa Clara at Almaden,11,5,Adobe on Almaden,19,36,10
46,2157.0869565217395,8,San Salvador at 1st,15,4,Santa Clara at Almaden,11,31,15
46,1133.6521739130437,46,Washington at Kearney,15,76,Market at 4th,19,23,23
46,1017.0869565217392,69,San Francisco Caltrain 2 (330 Townsend),23,46,Washington at Kearney,15,43,3
46,2019.6521739130437,5,Adobe on Almaden,19,14,Arena Green / SAP Center,19,21,25
46,943.3913043478262,5,Adobe on Almaden,19,4,Santa Clara at Almaden,11,32,14
46,1192.7173913043482,59,Golden Gate at Polk,23,54,Embarcadero at Bryant,15,38,8
45,775.7999999999998,13,St James Park,15,16,SJSU - San Salvador at 9th,15,33,12
45,2782.777777777778,47,Post at Kearney,19,76,Market at 4th,19,35,10
45,1153.0,9,Japantown,15,14,Arena Green / SAP Center,19,24,21
45,5191.200000000001,46,Washington at Kearney,15,73,Grant Avenue at Columbus Avenue,19,13,32
45,4324.866666666667,46,Washington at Kearny,15,45,Commercial at Montgomery,15,28,17
44,952.25,46,Washington at Kearney,15,54,Embarcadero at Bryant,15,28,16
44,964.0227272727275,59,Golden Gate at Polk,23,51,Embarcadero at Folsom,19,39,5
44,2872.7499999999986,13,St James Park,15,84,Ryland Park,15,35,9
44,967.7500000000002,11,MLK Library,19,84,Ryland Park,15,33,11
44,1681.0681818181824,10,San Jose City Hall,15,4,Santa Clara at Almaden,11,31,13
44,2343.7954545454545,11,MLK Library,19,5,Adobe on Almaden,19,30,14
43,963.0232558139536,73,Grant Avenue at Columbus Avenue,19,46,Washington at Kearney,15,28,15
43,1520.1627906976742,4,Santa Clara at Almaden,11,10,San Jose City Hall,15,24,19
43,959.2790697674419,42,Davis at Jackson,15,47,Post at Kearney,19,37,6
42,487.4285714285715,41,Clay at Battery,15,47,Post at Kearney,19,28,14
42,957.4761904761904,9,Japantown,15,5,Adobe on Almaden,19,30,12
42,4819.452380952382,46,Washington at Kearney,15,71,Powell at Post (Union Square),19,22,20
42,4166.809523809525,58,San Francisco City Hall,19,41,Clay at Battery,15,25,17
42,742.0714285714287,12,SJSU 4th at San Carlos,19,5,Adobe on Almaden,19,38,4
42,1245.7857142857142,2,San Jose Diridon Caltrain Station,27,80,Santa Clara County Civic Center,15,23,19
41,744.170731707317,4,Santa Clara at Almaden,11,16,SJSU - San Salvador at 9th,15,31,10
41,1533.5365853658534,47,Post at Kearney,19,42,Davis at Jackson,15,32,9
41,1182.3170731707314,49,Spear at Folsom,19,58,San Francisco City Hall,19,32,9
41,2051.0731707317077,29,San Antonio Caltrain Station,23,33,Charleston Park/ North Bayshore Area,15,15,26
41,3143.1463414634145,46,Washington at Kearney,15,70,San Francisco Caltrain (Townsend at 4th),19,32,9
41,1605.951219512195,9,Japantown,15,80,Santa Clara County Civic Center,15,24,17
40,548.2499999999999,75,Mechanics Plaza (Market at Battery),19,47,Post at Kearney,19,34,6
40,363.625,47,Post at Kearney,19,41,Clay at Battery,15,28,12
40,18873.499999999996,14,Arena Green / SAP Center,19,5,Adobe on Almaden,19,24,16
40,1174.7000000000003,46,Washington at Kearney,15,75,Mechanics Plaza (Market at Battery),19,27,13
40,1899.2000000000007,54,Embarcadero at Bryant,15,59,Golden Gate at Polk,23,28,12
40,1472.9499999999998,56,Beale at Market,19,47,Post at Kearney,19,27,13
39,9120.512820512822,22,Redwood City Caltrain Station,25,34,Palo Alto Caltrain Station,23,17,22
39,5476.769230769231,21,Franklin at Maple,15,21,Franklin at Maple,15,12,27
38,2006.9473684210525,5,Adobe on Almaden,19,13,St James Park,15,20,18
38,550.2368421052632,84,Ryland Park,15,13,St James Park,15,30,8
38,2739.2631578947367,14,Arena Green / SAP Center,19,10,San Jose City Hall,15,30,8
38,984.8421052631576,23,San Mateo County Center,15,26,Redwood City Medical Center,15,34,4
37,740.3783783783783,25,Stanford in Redwood City,15,23,San Mateo County Center,15,35,2
37,968.891891891892,66,South Van Ness at Market,19,46,Washington at Kearney,15,27,10
37,859.1891891891893,13,St James Park,15,3,San Jose Civic Center,15,11,26
37,651.027027027027,62,2nd at Folsom,19,46,Washington at Kearney,15,35,2
37,312.1351351351351,68,Yerba Buena Center of the Arts (3rd @ Howard),19,47,Post at Kearney,19,32,5
37,800.108108108108,46,Washington at Kearney,15,47,Post at Kearney,19,28,9
37,1447.4054054054054,51,Embarcadero at Folsom,19,59,Golden Gate at Polk,23,31,6
37,631.6486486486486,5,Adobe on Almaden,19,16,SJSU - San Salvador at 9th,15,28,9
37,652.3243243243244,76,Market at 4th,19,47,Post at Kearney,19,32,5
36,2463.4722222222217,48,Embarcadero at Vallejo,15,58,San Francisco City Hall,19,23,13
36,1104.8055555555559,4,Santa Clara at Almaden,11,9,Japantown,15,23,13
36,797.2777777777777,54,Embarcadero at Bryant,15,46,Washington at Kearney,15,30,6
36,1731.4722222222222,34,Palo Alto Caltrain Station,23,29,San Antonio Caltrain Station,23,30,6
36,1530.8333333333333,14,Arena Green / SAP Center,19,12,SJSU 4th at San Carlos,19,17,19
36,843.0,59,Golden Gate at Polk,23,62,2nd at Folsom,19,26,10
36,10838.722222222224,83,Mezes Park,15,83,Mezes Park,15,8,28
36,1542.25,31,San Antonio Shopping Center,15,36,California Ave Caltrain Station,15,31,5
35,295.91428571428577,47,Post at Kearney,19,56,Beale at Market,19,27,8
35,2056.2,56,Beale at Market,19,46,Washington at Kearney,15,26,9
34,13375.117647058823,29,San Antonio Caltrain Station,23,34,Palo Alto Caltrain Station,23,6,28
34,1333.6764705882351,16,SJSU - San Salvador at 9th,15,9,Japantown,15,17,17
34,1040.941176470588,59,Golden Gate at Polk,23,42,Davis at Jackson,15,29,5
33,416.4242424242426,47,Post at Kearney,19,68,Yerba Buena Center of the Arts (3rd @ Howard),19,28,5
33,2763.7272727272725,46,Washington at Kearney,15,63,Howard at 2nd,19,21,12
33,1054.7272727272725,74,Steuart at Market,23,46,Washington at Kearney,15,15,18
33,768.5151515151515,13,St James Park,15,80,Santa Clara County Civic Center,15,25,8
32,644.8125,47,Post at Kearney,19,51,Embarcadero at Folsom,19,23,9
32,860.0000000000001,5,Adobe on Almaden,19,9,Japantown,15,23,9
32,1236.8125000000002,42,Davis at Jackson,15,58,San Francisco City Hall,19,24,8
32,1153.0312500000002,82,Broadway St at Battery St,15,58,San Francisco City Hall,19,30,2
32,1542.6250000000002,30,Middlefield Light Rail Station,15,28,Mountain View Caltrain Station,23,19,13
31,910.2258064516129,45,Commercial at Montgomery,15,46,Washington at Kearney,15,29,2
31,1369.032258064516,14,Arena Green / SAP Center,19,11,MLK Library,19,15,16
30,1298.1333333333334,80,Santa Clara County Civic Center,15,2,San Jose Diridon Caltrain Station,27,22,8
30,610.0333333333335,68,Yerba Buena Center of the Arts (3rd @ Howard),19,46,Washington at Kearney,15,19,11
30,771.4666666666664,84,Ryland Park,15,10,San Jose City Hall,15,23,7
30,2463.566666666667,30,Evelyn Park and Ride,15,32,Castro Street and El Camino Real,11,21,9
30,677.4333333333334,57,5th at Howard,15,46,Washington at Kearney,15,25,5
30,1131.9333333333332,3,San Jose Civic Center,15,13,St James Park,15,12,18
30,1257.5,47,Post at Kearney,19,48,Embarcadero at Vallejo,15,12,18
29,787.1379310344827,54,Embarcadero at Bryant,15,47,Post at Kearney,19,26,3
29,1122.9655172413793,70,San Francisco Caltrain (Townsend at 4th),19,46,Washington at Kearney,15,24,5
29,2439.241379310345,58,San Francisco City Hall,19,48,Embarcadero at Vallejo,15,11,18
29,1675.9310344827582,46,Washington at Kearney,15,48,Embarcadero at Vallejo,15,10,19
29,768.2068965517241,16,SJSU - San Salvador at 9th,15,4,Santa Clara at Almaden,11,19,10
29,1230.4482758620688,45,Commercial at Montgomery,15,46,Washington at Kearny,15,14,15
28,1455.8214285714287,38,Park at Olive,15,31,San Antonio Shopping Center,15,12,16
28,907.392857142857,46,Washington at Kearney,15,68,Yerba Buena Center of the Arts (3rd @ Howard),19,16,12
28,1104.142857142857,12,SJSU 4th at San Carlos,19,14,Arena Green / SAP Center,19,16,12
28,3485.25,58,San Francisco City Hall,19,82,Broadway St at Battery St,15,20,8
27,1516.62962962963,11,MLK Library,19,14,Arena Green / SAP Center,19,12,15
27,660.7777777777777,84,Ryland Park,15,4,Santa Clara at Almaden,11,17,10
27,844.925925925926,47,Post at Kearney,19,75,Mechanics Plaza (Market at Battery),19,16,11
27,838.9259259259259,72,Civic Center BART (7th at Market),23,46,Washington at Kearney,15,17,10
27,2322.0,4,Santa Clara at Almaden,11,84,Ryland Park,15,20,7
27,1425.2962962962958,61,2nd at Townsend,27,46,Washington at Kearney,15,10,17
27,740.8888888888888,47,Post at Kearney,19,54,Embarcadero at Bryant,15,23,4
26,1124.4615384615386,13,St James Park,15,4,Santa Clara at Almaden,11,15,11
26,633.230769230769,51,Embarcadero at Folsom,19,47,Post at Kearney,19,20,6
25,1491.1999999999998,54,Embarcadero at Bryant,15,58,San Francisco City Hall,19,16,9
25,815.1999999999999,63,Howard at 2nd,19,46,Washington at Kearney,15,16,9
25,652.0000000000002,41,Clay at Battery,15,46,Washington at Kearney,15,16,9
25,12219.359999999999,47,Post at Kearney,19,77,Market at Sansome,27,16,9
24,2470.0416666666665,46,Washington at Kearney,15,42,Davis at Jackson,15,17,7
24,3385.958333333333,46,Washington at Kearney,15,64,2nd at South Park,15,19,5
24,907.8333333333335,12,SJSU 4th at San Carlos,19,84,Ryland Park,15,11,13
24,675.5416666666666,84,Ryland Park,15,8,San Salvador at 1st,15,22,2
24,7475.708333333333,32,Castro Street and El Camino Real,11,30,Evelyn Park and Ride,15,21,3
24,1702.1249999999998,27,Mountain View City Hall,15,33,Charleston Park/ North Bayshore Area,15,7,17
24,1383.125,4,Santa Clara at Almaden,11,13,St James Park,15,12,12
24,2790.541666666667,38,Park at Olive,15,33,Rengstorff Avenue / California Street,15,9,15
23,5380.782608695653,10,San Jose City Hall,15,84,Ryland Park,15,14,9
23,726.7391304347826,46,Washington at Kearney,15,49,Spear at Folsom,19,20,3
23,278.34782608695656,23,San Mateo County Center,15,25,Broadway at Main,15,21,2
23,2355.260869565217,21,Franklin at Maple,15,24,Redwood City Public Library,15,17,6
23,1935.0000000000002,28,Mountain View Caltrain Station,23,38,Park at Olive,15,6,17
23,1742.3913043478265,38,Park at Olive,15,28,Mountain View Caltrain Station,23,15,8
22,1503.0,58,San Francisco City Hall,19,54,Embarcadero at Bryant,15,19,3
22,4393.363636363637,51,Embarcadero at Folsom,19,58,San Francisco City Hall,19,17,5
22,1752.090909090909,25,Stanford in Redwood City,15,24,Redwood City Public Library,15,8,14
22,1338.6363636363637,80,Santa Clara County Civic Center,15,3,San Jose Civic Center,15,4,18
22,497.27272727272725,24,Redwood City Public Library,15,21,Franklin at Maple,15,18,4
22,9154.500000000002,34,Palo Alto Caltrain Station,23,28,Mountain View Caltrain Station,23,5,17
22,545.0000000000001,8,San Salvador at 1st,15,84,Ryland Park,15,22,0
21,232.80952380952385,39,Powell Street BART,19,90,5th St at Folsom St,31,19,2
21,12895.904761904761,26,Redwood City Medical Center,15,26,Redwood City Medical Center,15,14,7
21,2599.6190476190477,35,University and Emerson,11,29,San Antonio Caltrain Station,23,10,11
21,4855.571428571429,3,San Jose Civic Center,15,80,Santa Clara County Civic Center,15,1,20
21,1330.5714285714287,33,Charleston Park/ North Bayshore Area,15,29,San Antonio Caltrain Station,23,12,9
20,628.65,42,Davis at Jackson,15,46,Washington at Kearney,15,15,5
20,285.80000000000007,76,Market at 4th,19,90,5th St at Folsom St,31,20,0
20,8794.550000000001,29,San Antonio Caltrain Station,23,35,University and Emerson,11,6,14
20,5800.2,36,California Ave Caltrain Station,15,31,San Antonio Shopping Center,15,11,9
20,3183.9000000000005,33,Rengstorff Avenue / California Street,15,36,California Ave Caltrain Station,15,9,11
20,843.5,23,San Mateo County Center,15,25,Stanford in Redwood City,15,16,4
20,344.95000000000005,90,5th St at Folsom St,31,76,Market at 4th,19,20,0
20,1932.7000000000005,58,San Francisco City Hall,19,51,Embarcadero at Folsom,19,11,9
19,1549.2631578947369,31,San Antonio Shopping Center,15,38,Park at Olive,15,9,10
19,1999.6842105263158,32,Castro Street and El Camino Real,11,33,Charleston Park/ North Bayshore Area,15,3,16
19,313.3157894736842,25,Broadway at Main,15,23,San Mateo County Center,15,18,1
19,1018.4210526315788,14,Arena Green / SAP Center,19,16,SJSU - San Salvador at 9th,15,11,8
19,983.5789473684212,80,Santa Clara County Civic Center,15,13,St James Park,15,17,2
19,1035.3684210526314,46,Washington at Kearney,15,57,5th at Howard,15,10,9
18,705.0555555555557,89,S. Market St at Park Ave,19,2,San Jose Diridon Caltrain Station,27,10,8
18,1304.5555555555554,46,Washington at Kearney,15,65,Townsend at 7th,15,7,11
18,399.3333333333334,70,San Francisco Caltrain (Townsend at 4th),19,90,5th St at Folsom St,31,18,0
18,12950.333333333332,29,San Antonio Caltrain Station,23,32,Castro Street and El Camino Real,11,5,13
18,277.1111111111111,90,5th St at Folsom St,31,69,San Francisco Caltrain 2 (330 Townsend),23,18,0
18,883.4444444444445,46,Washington at Kearney,15,72,Civic Center BART (7th at Market),23,7,11
18,1199.0555555555557,10,San Jose City Hall,15,80,Santa Clara County Civic Center,15,12,6
18,675.3888888888889,89,S. Market St at Park Ave,19,6,San Pedro Square,15,11,7
17,2134.1176470588234,33,Charleston Park/ North Bayshore Area,15,27,Mountain View City Hall,15,5,12
17,954.0000000000001,16,SJSU - San Salvador at 9th,15,14,Arena Green / SAP Center,19,15,2
17,1074.1176470588236,80,Santa Clara County Civic Center,15,11,MLK Library,19,13,4
17,1253.235294117647,65,Townsend at 7th,15,46,Washington at Kearney,15,10,7
17,1966.0,46,Washington at Kearney,15,41,Clay at Battery,15,10,7
17,489.3529411764706,90,5th St at Folsom St,31,59,Golden Gate at Polk,23,16,1
17,2268.4705882352937,33,Rengstorff Avenue / California Street,15,32,Castro Street and El Camino Real,11,7,10
17,1562.764705882353,11,MLK Library,19,80,Santa Clara County Civic Center,15,7,10
17,2106.764705882353,30,Middlefield Light Rail Station,15,30,Middlefield Light Rail Station,15,1,16
17,520.1176470588236,6,San Pedro Square,15,89,S. Market St at Park Ave,19,10,7
16,1389.3125,32,Castro Street and El Camino Real,11,29,San Antonio Caltrain Station,23,8,8
16,448.81250000000006,48,Embarcadero at Vallejo,15,46,Washington at Kearney,15,11,5
16,2090.5,46,Washington at Kearney,15,61,2nd at Townsend,27,8,8
16,5337.062500000001,27,Mountain View City Hall,15,38,Park at Olive,15,3,13
16,783.5625,24,Redwood City Public Library,15,25,Stanford in Redwood City,15,6,10
16,272.125,69,San Francisco Caltrain 2 (330 Townsend),23,90,5th St at Folsom St,31,16,0
16,1001.1874999999999,31,San Antonio Shopping Center,15,33,Charleston Park/ North Bayshore Area,15,5,11
16,1404.125,32,Castro Street and El Camino Real,11,33,Rengstorff Avenue / California Street,15,5,11
16,1068.9375,46,Washington at Kearney,15,66,South Van Ness at Market,19,6,10
16,1038.8125,80,Santa Clara County Civic Center,15,10,San Jose City Hall,15,11,5
16,5463.062500000001,25,Broadway at Main,15,25,Broadway at Main,15,3,13
15,828.2,90,5th St at Folsom St,31,61,2nd at Townsend,27,11,4
15,3443.533333333333,46,Washington at Kearney,15,58,San Francisco City Hall,19,6,9
15,12383.4,33,Rengstorff Avenue / California Street,15,38,Park at Olive,15,3,12
15,1437.5999999999997,77,Market at Sansome,27,47,Post at Kearney,19,8,7
14,4132.142857142856,46,Washington at Kearney,15,59,Golden Gate at Polk,23,2,12
14,650.2857142857143,83,Mezes Park,15,24,Redwood City Public Library,15,7,7
14,492.21428571428567,75,Mechanics Plaza (Market at Battery),19,90,5th St at Folsom St,31,14,0
14,280.3571428571429,90,5th St at Folsom St,31,39,Powell Street BART,19,14,0
14,5952.285714285715,89,S. Market St at Park Ave,19,89,S. Market St at Park Ave,19,2,12
13,5066.307692307693,46,Washington at Kearney,15,45,Commercial at Montgomery,15,6,7
13,2466.6153846153843,34,Palo Alto Caltrain Station,23,31,San Antonio Shopping Center,15,5,8
13,1511.3846153846152,22,Redwood City Caltrain Station,25,25,Broadway at Main,15,9,4
13,1011.2307692307693,33,Charleston Park/ North Bayshore Area,15,31,San Antonio Shopping Center,15,6,7
13,385.8461538461539,59,Golden Gate at Polk,23,90,5th St at Folsom St,31,12,1
13,1328.3846153846157,4,Santa Clara at Almaden,11,80,Santa Clara County Civic Center,15,3,10
13,2308.3076923076924,34,Palo Alto Caltrain Station,23,22,Redwood City Caltrain Station,25,8,5
12,466.8333333333333,83,Mezes Park,15,23,San Mateo County Center,15,10,2
12,579.3333333333334,10,San Jose City Hall,15,89,S. Market St at Park Ave,19,10,2
12,483.74999999999994,21,Franklin at Maple,15,25,Broadway at Main,15,9,3
12,7885.249999999999,8,San Salvador at 1st,15,80,Santa Clara County Civic Center,15,2,10
12,3084.0000000000005,36,California Ave Caltrain Station,15,28,Mountain View Caltrain Station,23,3,9
12,1230.25,5,Adobe on Almaden,19,80,Santa Clara County Civic Center,15,5,7
12,913.2499999999999,84,Ryland Park,15,89,S. Market St at Park Ave,19,3,9
12,1323.8333333333333,80,Santa Clara County Civic Center,15,16,SJSU - San Salvador at 9th,15,6,6
12,3448.8333333333335,33,Rengstorff Avenue / California Street,15,35,University and Emerson,11,1,11
11,589.0909090909091,26,Kaiser Hospital,15,23,San Mateo County Center,15,10,1
11,3385.0000000000005,21,Franklin at Maple,15,35,University and Emerson,11,0,11
11,1515.272727272727,36,California Ave Caltrain Station,15,33,Rengstorff Avenue / California Street,15,6,5
11,1279.5454545454545,16,SJSU - San Salvador at 9th,15,80,Santa Clara County Civic Center,15,11,0
11,68240.27272727275,28,Mountain View Caltrain Station,23,34,Palo Alto Caltrain Station,23,1,10
11,352.54545454545456,25,Broadway at Main,15,22,Redwood City Caltrain Station,25,9,2
11,2083.090909090909,26,Redwood City Medical Center,15,24,Redwood City Public Library,15,8,3
11,1049.090909090909,9,Japantown,15,80,San Jose Government Center,15,3,8
11,872.7272727272727,46,Washington at Kearney,15,62,2nd at Folsom,19,9,2
10,1050.6,80,Santa Clara County Civic Center,15,4,Santa Clara at Almaden,11,7,3
10,2881.4,37,Cowper at University,11,29,San Antonio Caltrain Station,23,6,4
10,838.4999999999999,90,5th St at Folsom St,31,74,Steuart at Market,23,6,4
10,2993.1,23,San Mateo County Center,15,83,Mezes Park,15,7,3
10,1811.7,80,Santa Clara County Civic Center,15,7,Paseo de San Antonio,15,5,5
10,3438.8,91,Cyril Magnin St at Ellis St,35,91,Cyril Magnin St at Ellis St,35,0,10
10,1206.9,80,Santa Clara County Civic Center,15,5,Adobe on Almaden,19,2,8
10,597.4999999999999,91,Cyril Magnin St at Ellis St,35,70,San Francisco Caltrain (Townsend at 4th),19,9,1
10,3450.3,83,Mezes,15,83,Mezes,15,3,7
10,4152.199999999999,48,Embarcadero at Vallejo,15,47,Post at Kearney,19,6,4
10,5898.1,33,Charleston Park/ North Bayshore Area,15,35,University and Emerson,11,0,10
10,2851.5,33,Charleston Park/ North Bayshore Area,15,32,Castro Street and El Camino Real,11,1,9
10,15188.100000000002,35,University and Emerson,11,28,Mountain View Caltrain Station,23,0,10
9,3564.8888888888887,30,Middlefield Light Rail Station,15,33,Charleston Park/ North Bayshore Area,15,1,8
9,2063.0,26,Redwood City Medical Center,15,25,Broadway at Main,15,5,4
9,936.0,80,San Jose Government Center,15,9,Japantown,15,1,8
9,471.8888888888889,90,5th St at Folsom St,31,47,Post at Kearny,19,8,1
9,308.0,72,Civic Center BART (7th at Market),23,90,5th St at Folsom St,31,9,0
9,859.6666666666666,14,Arena Green / SAP Center,19,89,S. Market St at Park Ave,19,2,7
9,2108.1111111111113,25,Stanford in Redwood City,15,37,Cowper at University,11,6,3
9,531.4444444444445,21,Sequoia Hospital,15,22,Redwood City Caltrain Station,25,4,5
9,4915.222222222223,22,Redwood City Caltrain Station,25,35,University and Emerson,11,0,9
9,836.0,22,Redwood City Caltrain Station,25,21,Sequoia Hospital,15,3,6
9,946.8888888888889,23,San Mateo County Center,15,26,Kaiser Hospital,15,9,0
9,1025.3333333333333,58,San Francisco City Hall,19,46,Washington at Kearney,15,7,2
9,527.8888888888889,67,Market at 10th,27,91,Cyril Magnin St at Ellis St,35,2,7
8,7160.625,12,SJSU 4th at San Carlos,19,80,Santa Clara County Civic Center,15,4,4
8,815.5,90,5th St at Folsom St,31,49,Spear at Folsom,19,4,4
8,2261.5,36,California Ave Caltrain Station,15,27,Mountain View City Hall,15,3,5
8,512.25,61,2nd at Townsend,27,90,5th St at Folsom St,31,7,1
8,805.0,2,San Jose Diridon Caltrain Station,27,89,S. Market St at Park Ave,19,7,1
8,7561.499999999999,25,Broadway at Main,15,26,Redwood City Medical Center,15,7,1
8,1886.1249999999998,38,Park at Olive,15,27,Mountain View City Hall,15,0,8
8,5015.75,28,Mountain View Caltrain Station,23,35,University and Emerson,11,0,8
8,230.12500000000003,90,5th St at Folsom St,31,57,5th at Howard,15,2,6
8,965.125,24,Redwood City Public Library,15,83,Mezes Park,15,6,2
8,1228.875,29,San Antonio Caltrain Station,23,30,Evelyn Park and Ride,15,7,1
8,3095.5,27,Mountain View City Hall,15,36,California Ave Caltrain Station,15,2,6
8,520.75,90,5th St at Folsom St,31,75,Mechanics Plaza (Market at Battery),19,7,1
8,919.5,59,Golden Gate at Polk,23,46,Washington at Kearney,15,4,4
8,1146.5000000000002,30,Evelyn Park and Ride,15,33,Rengstorff Avenue / California Street,15,3,5
8,644.375,25,Stanford in Redwood City,15,88,5th S at E. San Salvador St,19,8,0
8,3012.6250000000005,3,San Jose Civic Center,15,89,S. Market St at Park Ave,19,0,8
7,295.8571428571429,25,Broadway at Main,15,21,Franklin at Maple,15,6,1
7,2693.0,36,California Ave Caltrain Station,15,33,Charleston Park/ North Bayshore Area,15,0,7
7,818.5714285714286,91,Cyril Magnin St at Ellis St,35,65,Townsend at 7th,15,2,5
7,1880.2857142857142,88,5th S at E. San Salvador St,19,88,5th S at E. San Salvador St,19,4,3
7,4719.0,28,Mountain View Caltrain Station,23,36,California Ave Caltrain Station,15,2,5
6,1428.6666666666667,30,Evelyn Park and Ride,15,29,San Antonio Caltrain Station,23,3,3
6,2520.833333333333,60,Embarcadero at Sansome,15,91,Cyril Magnin St at Ellis St,35,0,6
6,2955.5,25,Stanford in Redwood City,15,35,University and Emerson,11,2,4
6,960.1666666666667,84,Ryland Park,15,16,SJSU - San Salvador at 9th,15,5,1
6,3436.166666666667,34,Palo Alto Caltrain Station,23,33,Rengstorff Avenue / California Street,15,2,4
6,2438.333333333333,36,California Ave Caltrain Station,15,25,Stanford in Redwood City,15,0,6
6,2049.0,31,San Antonio Shopping Center,15,34,Palo Alto Caltrain Station,23,2,4
6,2299.333333333333,26,Kaiser Hospital,15,26,Kaiser Hospital,15,3,3
6,1109.5,9,Japantown,15,89,S. Market St at Park Ave,19,0,6
6,729.0,21,Franklin at Maple,15,23,San Mateo County Center,15,6,0
6,819.1666666666666,24,Redwood City Public Library,15,83,Mezes,15,4,2
6,751.1666666666666,23,San Mateo County Center,15,21,Franklin at Maple,15,4,2
6,748.1666666666666,70,San Francisco Caltrain (Townsend at 4th),19,91,Cyril Magnin St at Ellis St,35,4,2
6,2503.1666666666665,35,University and Emerson,11,33,Rengstorff Avenue / California Street,15,2,4
6,704.0,89,S. Market St at Park Ave,19,14,Arena Green / SAP Center,19,2,4
6,13820.166666666666,34,Palo Alto Caltrain Station,23,33,Charleston Park/ North Bayshore Area,15,0,6
6,2148.8333333333335,24,Redwood City Public Library,15,37,Cowper at University,11,5,1
5,2230.6,21,Franklin at Maple,15,25,Stanford in Redwood City,15,0,5
5,1732.2,27,Mountain View City Hall,15,30,Middlefield Light Rail Station,15,2,3
5,3220.6,38,Park at Olive,15,32,Castro Street and El Camino Real,11,1,4
5,6709.8,35,University and Emerson,11,33,Charleston Park/ North Bayshore Area,15,0,5
5,1001.0,91,Cyril Magnin St at Ellis St,35,50,Harry Bridges Plaza (Ferry Building),23,1,4
5,587.2,69,San Francisco Caltrain 2 (330 Townsend),23,91,Cyril Magnin St at Ellis St,35,5,0
5,1636.6,30,Middlefield Light Rail Station,15,27,Mountain View City Hall,15,2,3
5,7212.0,7,Paseo de San Antonio,15,80,Santa Clara County Civic Center,15,0,5
5,895.0,90,5th St at Folsom St,31,66,South Van Ness at Market,19,5,0
5,1217.4,33,Rengstorff Avenue / California Street,15,30,Evelyn Park and Ride,15,2,3
5,434.2,91,Cyril Magnin St at Ellis St,35,67,Market at 10th,27,3,2
5,822.8,24,Redwood City Public Library,15,26,Redwood City Medical Center,15,5,0
4,1976.25,34,Palo Alto Caltrain Station,23,24,Redwood City Public Library,15,0,4
4,7797.0,39,Powell Street BART,19,91,Cyril Magnin St at Ellis St,35,0,4
4,8939.25,3,San Jose Civic Center,15,28,Mountain View Caltrain Station,23,0,4
4,24823.5,22,Redwood City Caltrain Station,25,70,San Francisco Caltrain (Townsend at 4th),19,0,4
4,1923.0,83,Mezes Park,15,26,Redwood City Medical Center,15,0,4
4,5821.0,80,Santa Clara County Civic Center,15,12,SJSU 4th at San Carlos,19,4,0
4,4727.0,37,Cowper at University,11,28,Mountain View Caltrain Station,23,2,2
4,2301.25,22,Redwood City Caltrain Station,25,38,Park at Olive,15,4,0
4,509.0,58,San Francisco City Hall,19,90,5th St at Folsom St,31,4,0
4,1585.75,35,University and Emerson,11,25,Stanford in Redwood City,15,4,0
4,20260.5,46,Washington at Kearny,15,91,Cyril Magnin St at Ellis St,35,0,4
4,4189.75,33,Charleston Park/ North Bayshore Area,15,38,Park at Olive,15,0,4
4,972.5,21,Franklin at Maple,15,83,Mezes Park,15,0,4
4,26808.25,32,Castro Street and El Camino Real,11,38,Park at Olive,15,1,3
4,629.25,26,Redwood City Medical Center,15,21,Franklin at Maple,15,3,1
4,8223.5,91,Cyril Magnin St at Ellis St,35,59,Golden Gate at Polk,23,0,4
4,3904.75,35,University and Emerson,11,32,Castro Street and El Camino Real,11,0,4
4,3584.75,21,Sequoia Hospital,15,21,Sequoia Hospital,15,2,2
4,539.5,90,5th St at Folsom St,31,72,Civic Center BART (7th at Market),23,4,0
4,9948.25,46,Washington at Kearney,15,82,Broadway St at Battery St,15,2,2
4,291.25,90,5th St at Folsom St,31,70,San Francisco Caltrain (Townsend at 4th),19,4,0
4,2029.75,30,Evelyn Park and Ride,15,31,San Antonio Shopping Center,15,3,1
4,461.25,89,S. Market St at Park Ave,19,22,Redwood City Caltrain Station,25,4,0
4,337.0,89,S. Market St at Park Ave,19,10,San Jose City Hall,15,4,0
4,11184.75,27,Mountain View City Hall,15,34,Palo Alto Caltrain Station,23,0,4
4,495.25,24,Redwood City Public Library,15,26,Kaiser Hospital,15,3,1
4,1618.0,14,Arena Green / SAP Center,19,80,San Jose Government Center,15,2,2
4,1114.0,90,5th St at Folsom St,31,65,Townsend at 7th,15,1,3
4,1148.0,80,Santa Clara County Civic Center,15,8,San Salvador at 1st,15,4,0
3,874.3333333333334,16,SJSU - San Salvador at 9th,15,84,Ryland Park,15,3,0
3,2478.6666666666665,37,Cowper at University,11,33,Rengstorff Avenue / California Street,15,0,3
3,2301.3333333333335,35,University and Emerson,11,21,Franklin at Maple,15,0,3
3,1247.0,91,Cyril Magnin St at Ellis St,35,48,Embarcadero at Vallejo,15,1,2
3,418.0,65,Townsend at 7th,15,90,5th St at Folsom St,31,3,0
3,2373.0,37,Cowper at University,11,24,Redwood City Public Library,15,1,2
3,693.0,25,Stanford in Redwood City,15,26,Kaiser Hospital,15,2,1
3,1192.0,32,Castro Street and El Camino Real,11,30,Middlefield Light Rail Station,15,0,3
3,4027.0,74,Steuart at Market,23,90,5th St at Folsom St,31,1,2
3,6833.333333333333,8,San Salvador at 1st,15,31,San Antonio Shopping Center,15,0,3
3,1630.0,37,Cowper at University,11,25,Broadway at Main,15,2,1
3,2870.0,21,Franklin at Maple,15,34,Palo Alto Caltrain Station,23,0,3
3,261.3333333333333,22,Redwood City Caltrain Station,25,89,S. Market St at Park Ave,19,3,0
3,1330.0,80,San Jose Government Center,15,10,San Jose City Hall,15,3,0
3,1002.3333333333334,80,San Jose Government Center,15,6,San Pedro Square,15,3,0
3,3592.666666666667,48,Embarcadero at Vallejo,15,91,Cyril Magnin St at Ellis St,35,0,3
3,904.0,80,San Jose Government Center,15,13,St James Park,15,2,1
3,83205.0,2,San Jose Diridon Caltrain Station,27,28,Mountain View Caltrain Station,23,0,3
3,297.3333333333333,89,S. Market St at Park Ave,19,11,MLK Library,19,3,0
3,3666.3333333333335,28,Mountain View Caltrain Station,23,37,Cowper at University,11,0,3
3,11562.0,35,University and Emerson,11,27,Mountain View City Hall,15,0,3
3,1285.6666666666667,71,Powell at Post (Union Square),19,90,5th St at Folsom St,31,1,2
3,512.3333333333334,16,SJSU - San Salvador at 9th,15,89,S. Market St at Park Ave,19,2,1
3,1055.6666666666667,91,Cyril Magnin St at Ellis St,35,60,Embarcadero at Sansome,15,0,3
3,1628.6666666666667,37,Cowper at University,11,25,Stanford in Redwood City,15,1,2
3,3637.333333333333,35,University and Emerson,11,24,Redwood City Public Library,15,0,3
3,10765.333333333334,89,S. Market St at Park Ave,19,3,San Jose Civic Center,15,0,3
3,3188.6666666666665,74,Steuart at Market,23,22,Redwood City Caltrain Station,25,3,0
3,3694.6666666666665,21,Franklin at Maple,15,26,Redwood City Medical Center,15,2,1
3,2605.666666666667,35,University and Emerson,11,22,Redwood City Caltrain Station,25,1,2
3,430.0,90,5th St at Folsom St,31,56,Beale at Market,19,3,0
3,787.6666666666666,89,S. Market St at Park Ave,19,16,SJSU - San Salvador at 9th,15,1,2
3,992.6666666666666,90,5th St at Folsom St,31,50,Harry Bridges Plaza (Ferry Building),23,0,3
3,10271.666666666666,33,Charleston Park/ North Bayshore Area,15,34,Palo Alto Caltrain Station,23,0,3
3,352.3333333333333,90,5th St at Folsom St,31,62,2nd at Folsom,19,2,1
3,3251.3333333333335,29,San Antonio Caltrain Station,23,37,Cowper at University,11,0,3
3,860.6666666666667,56,Beale at Market,19,90,5th St at Folsom St,31,1,2
3,431.0,47,Post at Kearney,19,82,Broadway St at Battery St,15,3,0
3,28750.333333333336,24,Redwood City Public Library,15,25,Broadway at Main,15,2,1
3,309.6666666666667,25,Broadway at Main,15,24,Redwood City Public Library,15,3,0
3,588.3333333333334,83,Mezes,15,24,Redwood City Public Library,15,0,3
3,2500.666666666667,26,Kaiser Hospital,15,24,Redwood City Public Library,15,2,1
3,43369.666666666664,27,Mountain View City Hall,15,80,Santa Clara County Civic Center,15,0,3
3,6740.666666666666,33,Charleston Park/ North Bayshore Area,15,36,California Ave Caltrain Station,15,0,3
3,19348.333333333332,35,University and Emerson,11,70,San Francisco Caltrain (Townsend at 4th),19,0,3
3,1088.6666666666667,11,MLK Library,19,89,S. Market St at Park Ave,19,1,2
2,269.0,83,Mezes,15,23,San Mateo County Center,15,2,0
2,611.5,90,5th St at Folsom St,31,58,San Francisco City Hall,19,2,0
2,15861.5,29,San Antonio Caltrain Station,23,76,Market at 4th,19,0,2
2,5002.5,26,Redwood City Medical Center,15,37,Cowper at University,11,0,2
2,4790.0,88,5th S at E. San Salvador St,19,4,Santa Clara at Almaden,11,0,2
2,922.0,89,S. Market St at Park Ave,19,12,SJSU 4th at San Carlos,19,0,2
2,76833.0,34,Palo Alto Caltrain Station,23,70,San Francisco Caltrain (Townsend at 4th),19,0,2
2,31461.0,29,San Antonio Caltrain Station,23,67,Market at 10th,27,0,2
2,3046.5,34,Palo Alto Caltrain Station,23,27,Mountain View City Hall,15,0,2
2,404.5,89,S. Market St at Park Ave,19,13,St James Park,15,2,0
2,1082.5,25,Broadway at Main,15,83,Mezes Park,15,0,2
2,689.5,91,Cyril Magnin St at Ellis St,35,71,Powell at Post (Union Square),19,1,1
2,3998.5,21,Franklin at Maple,15,37,Cowper at University,11,0,2
2,2980.0,29,San Antonio Caltrain Station,23,25,Stanford in Redwood City,15,0,2
2,1059.0,91,Cyril Magnin St at Ellis St,35,55,Temporary Transbay Terminal (Howard at Beale),23,0,2
2,5807.5,31,San Antonio Shopping Center,15,37,Cowper at University,11,1,1
2,3021.0,37,Cowper at University,11,27,Mountain View City Hall,15,1,1
2,1343.0,80,San Jose Government Center,15,16,SJSU - San Salvador at 9th,15,2,0
2,10544.0,33,Rengstorff Avenue / California Street,15,9,Japantown,15,0,2
2,2004.0,91,Cyril Magnin St at Ellis St,35,66,South Van Ness at Market,19,1,1
2,78068.5,32,Castro Street and El Camino Real,11,2,San Jose Diridon Caltrain Station,27,0,2
2,642.0,88,5th S at E. San Salvador St,19,6,San Pedro Square,15,2,0
2,134.0,89,S. Market St at Park Ave,19,5,Adobe on Almaden,19,2,0
2,1049.0,6,San Pedro Square,15,80,San Jose Government Center,15,2,0
2,10918.0,11,MLK Library,19,88,5th S at E. San Salvador St,19,0,2
2,3339.0,37,Cowper at University,11,33,Charleston Park/ North Bayshore Area,15,0,2
2,3944.5,91,Cyril Magnin St at Ellis St,35,68,Yerba Buena Center of the Arts (3rd @ Howard),19,0,2
2,433.5,83,Mezes Park,15,25,Broadway at Main,15,1,1
2,2531.5,37,Cowper at University,11,21,Franklin at Maple,15,0,2
2,883.0,59,Golden Gate at Polk,23,91,Cyril Magnin St at Ellis St,35,0,2
2,2620.5,22,Redwood City Caltrain Station,25,37,Cowper at University,11,1,1
2,179212.5,32,Castro Street and El Camino Real,11,63,Howard at 2nd,19,0,2
2,1934.0,31,San Antonio Shopping Center,15,30,Evelyn Park and Ride,15,2,0
2,2729.0,66,South Van Ness at Market,19,90,5th St at Folsom St,31,1,1
2,2024.0,90,5th St at Folsom St,31,90,5th St at Folsom St,31,0,2
2,197.5,71,Powell at Post (Union Square),19,91,Cyril Magnin St at Ellis St,35,1,1
2,626.5,88,5th S at E. San Salvador St,19,2,San Jose Diridon Caltrain Station,27,2,0
2,38320.5,34,Palo Alto Caltrain Station,23,32,Castro Street and El Camino Real,11,0,2
2,7452.5,37,Cowper at University,11,30,Evelyn Park and Ride,15,0,2
2,488.0,90,5th St at Folsom St,31,67,Market at 10th,27,2,0
2,255.0,88,5th S at E. San Salvador St,19,89,S. Market St at Park Ave,19,2,0
2,636.0,91,Cyril Magnin St at Ellis St,35,74,Steuart at Market,23,1,1
2,10858.0,91,Cyril Magnin St at Ellis St,35,72,Civic Center BART (7th at Market),23,0,2
2,1071.5,50,Harry Bridges Plaza (Ferry Building),23,91,Cyril Magnin St at Ellis St,35,1,1
2,624.5,91,Cyril Magnin St at Ellis St,35,69,San Francisco Caltrain 2 (330 Townsend),23,2,0
2,20865.5,91,Cyril Magnin St at Ellis St,35,76,Market at 4th,19,1,1
2,3397.5,25,Stanford in Redwood City,15,21,Franklin at Maple,15,1,1
2,1918.5,35,University and Emerson,11,23,San Mateo County Center,15,0,2
2,381.5,26,Kaiser Hospital,15,88,5th S at E. San Salvador St,19,2,0
2,1247.5,7,Paseo de San Antonio,15,80,San Jose Government Center,15,2,0
2,3483.0,26,Redwood City Medical Center,15,25,Stanford in Redwood City,15,1,1
2,744.0,54,Embarcadero at Bryant,15,90,5th St at Folsom St,31,2,0
2,2517.5,83,Mezes Park,15,34,Palo Alto Caltrain Station,23,0,2
2,101207.5,28,Mountain View Caltrain Station,23,2,San Jose Diridon Caltrain Station,27,0,2
2,2191.0,34,Palo Alto Caltrain Station,23,21,Franklin at Maple,15,0,2
2,3105.5,24,Redwood City Public Library,15,35,University and Emerson,11,0,2
2,4433.5,27,Mountain View City Hall,15,35,University and Emerson,11,0,2
2,1382.0,50,Harry Bridges Plaza (Ferry Building),23,90,5th St at Folsom St,31,0,2
2,7428.5,23,San Mateo County Center,15,37,Cowper at University,11,2,0
2,1975.0,24,Redwood City Public Library,15,34,Palo Alto Caltrain Station,23,0,2
2,473.5,67,Market at 10th,27,90,5th St at Folsom St,31,2,0
2,232.0,68,Yerba Buena Center of the Arts (3rd @ Howard),19,90,5th St at Folsom St,31,1,1
2,329.5,13,St James Park,15,89,S. Market St at Park Ave,19,2,0
2,788.0,65,Townsend at 7th,15,91,Cyril Magnin St at Ellis St,35,0,2
2,246.5,90,5th St at Folsom St,31,68,Yerba Buena Center of the Arts (3rd @ Howard),19,1,1
2,1223.5,23,San Mateo County Center,15,83,Mezes,15,1,1
2,1511.0,90,5th St at Folsom St,31,48,Embarcadero at Vallejo,15,0,2
2,956.5,83,Mezes,15,25,Stanford in Redwood City,15,2,0
2,650.5,45,Commercial at Montgomery,15,91,Cyril Magnin St at Ellis St,35,1,1
2,1261.5,25,Stanford in Redwood City,15,26,Redwood City Medical Center,15,1,1
2,19059.5,69,San Francisco Caltrain 2 (330 Townsend),23,35,University and Emerson,11,0,2
2,77725.5,9,Japantown,15,37,Cowper at University,11,0,2
2,18484.0,11,MLK Library,19,28,Mountain View Caltrain Station,23,0,2
2,794.5,90,5th St at Folsom St,31,73,Grant Avenue at Columbus Avenue,19,2,0
2,434.0,77,Market at Sansome,27,90,5th St at Folsom St,31,2,0
2,1606.5,91,Cyril Magnin St at Ellis St,35,47,Post at Kearny,19,0,2
1,5041.0,28,Mountain View Caltrain Station,23,80,Santa Clara County Civic Center,15,0,1
1,4517.0,38,Park at Olive,15,30,Evelyn Park and Ride,15,0,1
1,6067.0,28,Mountain View Caltrain Station,23,9,Japantown,15,0,1
1,671.0,2,San Jose Diridon Caltrain Station,27,88,5th S at E. San Salvador St,19,1,0
1,7145.0,7,Paseo de San Antonio,15,70,San Francisco Caltrain (Townsend at 4th),19,1,0
1,25953.0,28,Mountain View Caltrain Station,23,13,St James Park,15,0,1
1,281.0,8,San Salvador at 1st,15,89,S. Market St at Park Ave,19,1,0
1,20491.0,66,South Van Ness at Market,19,34,Palo Alto Caltrain Station,23,1,0
1,84633.0,5,Adobe on Almaden,19,33,Rengstorff Avenue / California Street,15,0,1
1,686.0,9,Japantown,15,88,5th St at E. San Salvador St,19,0,1
1,299.0,90,5th St at Folsom St,31,63,Howard at 2nd,19,1,0
1,7012.0,26,Kaiser Hospital,15,25,Stanford in Redwood City,15,0,1
1,345.0,63,Howard at 2nd,19,90,5th St at Folsom St,31,1,0
1,13285.0,31,San Antonio Shopping Center,15,2,San Jose Diridon Caltrain Station,27,0,1
1,6162.0,39,Powell Street BART,19,31,San Antonio Shopping Center,15,1,0
1,441.0,90,5th St at Folsom St,31,46,Washington at Kearny,15,1,0
1,9517.0,83,Mezes,15,33,Charleston Park/ North Bayshore Area,15,0,1
1,877.0,88,5th S at E. San Salvador St,19,10,San Jose City Hall,15,0,1
1,54178.0,27,Mountain View City Hall,15,13,St James Park,15,0,1
1,2300.0,83,Mezes Park,15,36,California Ave Caltrain Station,15,1,0
1,870.0,51,Embarcadero at Folsom,19,91,Cyril Magnin St at Ellis St,35,0,1
1,2525.0,61,2nd at Townsend,27,22,Redwood City Caltrain Station,25,1,0
1,488.0,82,Broadway St at Battery St,15,47,Post at Kearney,19,1,0
1,29283.0,56,Beale at Market,19,3,San Jose Civic Center,15,1,0
1,6298.0,28,Mountain View Caltrain Station,23,70,San Francisco Caltrain (Townsend at 4th),19,0,1
1,499.0,91,Cyril Magnin St at Ellis St,35,64,2nd at South Park,15,1,0
1,3161.0,89,S. Market St at Park Ave,19,84,Ryland Park,15,0,1
1,330.0,90,5th St at Folsom St,31,64,2nd at South Park,15,1,0
1,1209.0,76,Market at 4th,19,91,Cyril Magnin St at Ellis St,35,0,1
1,1967.0,30,Middlefield Light Rail Station,15,29,San Antonio Caltrain Station,23,0,1
1,7131.0,31,San Antonio Shopping Center,15,70,San Francisco Caltrain (Townsend at 4th),19,0,1
1,3188.0,29,San Antonio Caltrain Station,23,30,Middlefield Light Rail Station,15,0,1
1,539.0,91,Cyril Magnin St at Ellis St,35,41,Clay at Battery,15,1,0
1,1342.0,80,San Jose Government Center,15,7,Paseo de San Antonio,15,1,0
1,20586.0,56,Beale at Market,19,83,Mezes Park,15,0,1
1,69840.0,24,Redwood City Public Library,15,32,Castro Street and El Camino Real,11,0,1
1,169308.0,80,Santa Clara County Civic Center,15,36,California Ave Caltrain Station,15,0,1
1,1860.0,23,San Mateo County Center,15,38,Park at Olive,15,1,0
1,236.0,22,Redwood City Caltrain Station,25,72,Civic Center BART (7th at Market),23,1,0
1,578.0,89,S. Market St at Park Ave,19,25,Stanford in Redwood City,15,1,0
1,1021.0,26,Kaiser Hospital,15,83,Mezes,15,1,0
1,17662.0,70,San Francisco Caltrain (Townsend at 4th),19,2,San Jose Diridon Caltrain Station,27,0,1
1,251.0,3,San Jose Civic Center,15,88,5th S at E. San Salvador St,19,1,0
1,2688.0,33,Charleston Park/ North Bayshore Area,15,37,Cowper at University,11,0,1
1,229914.0,26,Redwood City Medical Center,15,16,SJSU - San Salvador at 9th,15,1,0
1,556.0,82,Broadway St at Battery St,15,46,Washington at Kearney,15,1,0
1,28712.0,29,San Antonio Caltrain Station,23,8,San Salvador at 1st,15,0,1
1,1579.0,36,California Ave Caltrain Station,15,32,Castro Street and El Camino Real,11,0,1
1,11288.0,62,2nd at Folsom,19,10,San Jose City Hall,15,0,1
1,214.0,88,5th S at E. San Salvador St,19,7,Paseo de San Antonio,15,1,0
1,5640.0,65,Townsend at 7th,15,2,San Jose Diridon Caltrain Station,27,1,0
1,2457.0,22,Redwood City Caltrain Station,25,36,California Ave Caltrain Station,15,1,0
1,313.0,7,Paseo de San Antonio,15,89,S. Market St at Park Ave,19,1,0
1,7530.0,32,Castro Street and El Camino Real,11,37,Cowper at University,11,0,1
1,12088.0,3,San Jose Civic Center,15,72,Civic Center BART (7th at Market),23,0,1
1,4574.0,21,Sequoia Hospital,15,24,Redwood City Public Library,15,0,1
1,41312.0,4,Santa Clara at Almaden,11,70,San Francisco Caltrain (Townsend at 4th),19,0,1
1,15231.0,67,Market at 10th,27,8,San Salvador at 1st,15,0,1
1,1350.0,11,MLK Library,19,80,San Jose Government Center,15,1,0
1,915.0,80,San Jose Government Center,15,5,Adobe on Almaden,19,0,1
1,5327.0,27,Mountain View City Hall,15,57,5th at Howard,15,1,0
1,867.0,88,5th S at E. San Salvador St,19,9,Japantown,15,1,0
1,1006.0,83,Mezes,15,21,Sequoia Hospital,15,1,0
1,710.0,49,Spear at Folsom,19,91,Cyril Magnin St at Ellis St,35,1,0
1,12893.0,2,San Jose Diridon Caltrain Station,27,33,Rengstorff Avenue / California Street,15,0,1
1,16744.0,22,Redwood City Caltrain Station,25,28,Mountain View Caltrain Station,23,0,1
1,784.0,90,5th St at Folsom St,31,42,Davis at Jackson,15,1,0
1,56649.0,31,San Antonio Shopping Center,15,72,Civic Center BART (7th at Market),23,0,1
1,338.0,91,Cyril Magnin St at Ellis St,35,45,Commercial at Montgomery,15,1,0
1,557.0,12,SJSU 4th at San Carlos,19,89,S. Market St at Park Ave,19,1,0
1,9493.0,29,San Antonio Caltrain Station,23,21,Franklin at Maple,15,0,1
1,1492.0,80,San Jose Government Center,15,14,Arena Green / SAP Center,19,0,1
1,704.0,88,5th St at E. San Salvador St,19,2,San Jose Diridon Caltrain Station,27,1,0
1,56583.0,36,California Ave Caltrain Station,15,56,Beale at Market,19,1,0
1,303.0,72,Civic Center BART (7th at Market),23,91,Cyril Magnin St at Ellis St,35,1,0
1,852.0,90,5th St at Folsom St,31,45,Commercial at Montgomery,15,1,0
1,766.0,74,Steuart at Market,23,91,Cyril Magnin St at Ellis St,35,0,1
1,20620.0,22,Redwood City Caltrain Station,25,82,Broadway St at Battery St,15,1,0
1,1007.0,12,SJSU 4th at San Carlos,19,80,San Jose Government Center,15,1,0
1,4048.0,34,Palo Alto Caltrain Station,23,30,Evelyn Park and Ride,15,0,1
1,7798.0,7,Paseo de San Antonio,15,76,Market at 4th,19,0,1
1,80183.0,58,San Francisco City Hall,19,10,San Jose City Hall,15,0,1
1,215.0,89,S. Market St at Park Ave,19,88,5th S at E. San Salvador St,19,1,0
1,6598.0,36,California Ave Caltrain Station,15,77,Market at Sansome,27,0,1
1,18112.0,39,Powell Street BART,19,35,University and Emerson,11,0,1
1,1055.0,83,Mezes,15,26,Kaiser Hospital,15,1,0
1,5453.0,30,Middlefield Light Rail Station,15,38,Park at Olive,15,0,1
1,3796.0,38,Park at Olive,15,33,Charleston Park/ North Bayshore Area,15,0,1
1,735.0,55,Temporary Transbay Terminal (Howard at Beale),23,91,Cyril Magnin St at Ellis St,35,0,1
1,75844.0,2,San Jose Diridon Caltrain Station,27,37,Cowper at University,11,1,0
1,225.0,89,S. Market St at Park Ave,19,8,San Salvador at 1st,15,1,0
1,3347.0,25,Broadway at Main,15,36,California Ave Caltrain Station,15,0,1
1,3967.0,50,Harry Bridges Plaza (Ferry Building),23,22,Redwood City Caltrain Station,25,1,0
1,4148.0,57,5th at Howard,15,22,Redwood City Caltrain Station,25,1,0
1,1645.0,32,Castro Street and El Camino Real,11,36,California Ave Caltrain Station,15,0,1
1,5394.0,9,Japantown,15,30,Middlefield Light Rail Station,15,0,1
1,29942.0,11,MLK Library,19,76,Market at 4th,19,0,1
1,587.0,21,Sequoia Hospital,15,83,Mezes,15,1,0
1,1868.0,89,S. Market St at Park Ave,19,34,Palo Alto Caltrain Station,23,0,1
1,15125.0,33,Charleston Park/ North Bayshore Area,15,2,San Jose Diridon Caltrain Station,27,0,1
1,15940.0,38,Park at Olive,15,70,San Francisco Caltrain (Townsend at 4th),19,0,1
1,142.0,8,San Salvador at 1st,15,88,5th S at E. San Salvador St,19,1,0
1,2666.0,34,Palo Alto Caltrain Station,23,23,San Mateo County Center,15,0,1
1,1575.0,90,5th St at Folsom St,31,60,Embarcadero at Sansome,15,1,0
1,190.0,47,Post at Kearny,19,91,Cyril Magnin St at Ellis St,35,1,0
1,81.0,91,Cyril Magnin St at Ellis St,35,39,Powell Street BART,19,1,0
1,405.0,4,Santa Clara at Almaden,11,89,S. Market St at Park Ave,19,0,1
1,359.0,68,Yerba Buena Center of the Arts (3rd @ Howard),19,91,Cyril Magnin St at Ellis St,35,0,1
1,975.0,61,2nd at Townsend,27,91,Cyril Magnin St at Ellis St,35,1,0
1,489.0,90,5th St at Folsom St,31,77,Market at Sansome,27,0,1
1,4759.0,35,University and Emerson,11,30,Evelyn Park and Ride,15,0,1
1,4068.0,22,Redwood City Caltrain Station,25,29,San Antonio Caltrain Station,23,0,1
1,23661.0,76,Market at 4th,19,25,Stanford in Redwood City,15,0,1
1,2946.0,37,Cowper at University,11,31,San Antonio Shopping Center,15,1,0
1,1722.0,30,Middlefield Light Rail Station,15,32,Castro Street and El Camino Real,11,1,0
1,5682.0,11,MLK Library,19,70,San Francisco Caltrain (Townsend at 4th),19,1,0
1,4072.0,36,California Ave Caltrain Station,15,30,Evelyn Park and Ride,15,1,0
1,549.0,62,2nd at Folsom,19,91,Cyril Magnin St at Ellis St,35,1,0
1,439.0,66,South Van Ness at Market,19,91,Cyril Magnin St at Ellis St,35,0,1
1,3206.0,23,San Mateo County Center,15,35,University and Emerson,11,0,1
1,3237.0,45,Commercial at Montgomery,15,22,Redwood City Caltrain Station,25,0,1
1,12119.0,29,San Antonio Caltrain Station,23,22,Redwood City Caltrain Station,25,0,1
1,213.0,10,San Jose City Hall,15,88,5th S at E. San Salvador St,19,1,0
1,66748.0,76,Market at 4th,19,7,Paseo de San Antonio,15,0,1
1,27409.0,30,Evelyn Park and Ride,15,14,Arena Green / SAP Center,19,0,1
1,28226.0,70,San Francisco Caltrain (Townsend at 4th),19,29,San Antonio Caltrain Station,23,0,1
1,580.0,90,5th St at Folsom St,31,82,Broadway St at Battery St,15,1,0
1,1388.0,16,SJSU - San Salvador at 9th,15,80,San Jose Government Center,15,1,0
1,506.0,55,Temporary Transbay Terminal (Howard at Beale),23,90,5th St at Folsom St,31,1,0
1,150.0,88,5th S at E. San Salvador St,19,16,SJSU - San Salvador at 9th,15,1,0
1,3553.0,36,California Ave Caltrain Station,15,70,San Francisco Caltrain (Townsend at 4th),19,1,0
1,11083.0,29,San Antonio Caltrain Station,23,3,San Jose Civic Center,15,0,1
1,1203.0,10,San Jose City Hall,15,80,San Jose Government Center,15,1,0
1,6321.0,26,Redwood City Medical Center,15,83,Mezes Park,15,1,0
1,16402.0,31,San Antonio Shopping Center,15,60,Embarcadero at Sansome,15,0,1
1,2872.0,25,Stanford in Redwood City,15,36,California Ave Caltrain Station,15,0,1
1,4436.0,54,Embarcadero at Bryant,15,23,San Mateo County Center,15,1,0
